# 1956 漢字簡化方案 第二批
擺	摆
襬	摆
筆	笔
蘋	苹
買	买
賣	卖
麥	麦
滅	灭
畝	亩
飛	飞
礬	矾
糞	粪
導	导
鄧	邓
隊	队
噸	吨
廳	厅
寧	宁
農	农
來	来
曆	历
歷	历
隸	隶
療	疗
遼	辽
臨	临
齡	龄
錄	录
陸	陆
龍	龙
慮	虑
國	国
龜	龟
廣	广
誇	夸
擴	扩
虧	亏
礦	矿
漢	汉
華	华
獲	获
穫	获
積	积
階	阶
節	节
監	监
繭	茧
緊	紧
僅	仅
進	进
驚	惊
競	竞
懼	惧
殼	壳
竅	窍
簽	签
籤	签
親	亲
慶	庆
窮	穷
戲	戏
嚇	吓
寫	写
脅	胁
顯	显
憲	宪
縣	县
懸	悬
鄉	乡
尋	寻
趙	赵
鄭	郑
齒	齿
產	产
礎	础
適	适
殺	杀
獸	兽
審	审
勝	胜
術	术
樹	树
擾	扰
雜	杂
竄	窜
肅	肃
歲	岁
藝	艺
億	亿
憶	忆
爺	爷
艷	艳
嚴	严
隱	隐
穩	稳
譽	誉
園	园
傭	佣
踴	踊