# 新字體中在Unicode未分離者，在此字型需要區分
# 請注意此檔案不是真正從印刷通用漢字字形表整理而來，
# 而是單純思源宋體，清查出需要區分新舊字形的常用字
下	下.cn
不	不.cn
与	与.cn
丐	丐.cn
丑	丑.cn
丕	丕.cn
世	世.cn
乃	乃.cn
么	么.cn
之	之.cn
乏	乏.cn
乖	乖.cn
乳	乳.cn
云	云.cn
互	互.cn
亟	亟.cn
亡	亡.cn
亢	亢.cn
交	交.cn
亥	亥.cn
亦	亦.cn
亨	亨.cn
享	享.cn
京	京.cn
亭	亭.cn
亮	亮.cn
亳	亳.cn
今	今.cn
仍	仍.cn
仗	仗.cn
仙	仙.cn
令	令.cn
以	以.cn
仰	仰.cn
仳	仳.cn
份	份.cn
分	分.cn
仿	仿.cn
伉	伉.cn
伋	伋.cn
火	火.cn
伴	伴.cn
伶	伶.cn
似	似.cn
位	位.cn
低	低.cn
体	体.cn
佗	佗.cn
佛	佛.cn
佞	佞.cn
佟	佟.cn
佤	佤.cn
佴	佴.cn
佺	佺.cn
佼	佼.cn
佾	佾.cn
侄	侄.cn
耒	耒.cn
侉	侉.cn
侔	侔.cn
依	依.cn
侮	侮.cn
侯	侯.cn
侵	侵.cn
系	系.cn
俅	俅.cn
俊	俊.cn
俏	俏.cn
俘	俘.cn
俯	俯.cn
俜	俜.cn
俞	俞.cn
俟	俟.cn
信	信.cn
修	修.cn
俳	俳.cn
俸	俸.cn
倌	倌.cn
倍	倍.cn
倏	倏.cn
倒	倒.cn
倔	倔.cn
幸	幸.cn
倘	倘.cn
候	候.cn
倜	倜.cn
倥	倥.cn
倦	倦.cn
倩	倩.cn
倭	倭.cn
偃	偃.cn
偈	偈.cn
偎	偎.cn
偏	偏.cn
偕	偕.cn
停	停.cn
健	健.cn
逼	逼.cn
偯	偯.cn
偷	偷.cn
傀	傀.cn
傍	傍.cn
效	效.cn
家	家.cn
傣	傣.cn
催	催.cn
傲	傲.cn
傺	傺.cn
傻	傻.cn
僇	僇.cn
像	像.cn
象	象.cn
徼	徼.cn
僦	僦.cn
僧	僧.cn
僬	僬.cn
僭	僭.cn
僮	僮.cn
雇	雇.cn
僻	僻.cn
辟	辟.cn
儇	儇.cn
儋	儋.cn
儒	儒.cn
优	优.cn
儳	儳.cn
儸	儸.cn
允	允.cn
充	充.cn
兆	兆.cn
凶	凶.cn
兕	兕.cn
兜	兜.cn
兝	兝.cn
兢	兢.cn
入	入.cn
全	全.cn
八	八.cn
公	公.cn
六	六.cn
兮	兮.cn
具	具.cn
兼	兼.cn
再	再.cn
冒	冒.cn
冢	冢.cn
冤	冤.cn
冥	冥.cn
冬	冬.cn
冱	冱.cn
冶	冶.cn
冷	冷.cn
凄	凄.cn
准	准.cn
凋	凋.cn
雕	雕.cn
凌	凌.cn
凵	凵.cn
凸	凸.cn
凹	凹.cn
出	出.cn
函	函.cn
切	切.cn
刈	刈.cn
初	初.cn
判	判.cn
到	到.cn
刳	刳.cn
券	券.cn
刻	刻.cn
剃	剃.cn
削	削.cn
剖	剖.cn
剜	剜.cn
剡	剡.cn
剪	剪.cn
割	割.cn
劁	劁.cn
劂	劂.cn
劈	劈.cn
功	功.cn
劣	劣.cn
努	努.cn
劫	劫.cn
劻	劻.cn
劾	劾.cn
勇	勇.cn
勰	勰.cn
勾	勾.cn
匈	匈.cn
匏	匏.cn
匚	匚.cn
匝	匝.cn
炕	炕.cn
匠	匠.cn
匡	匡.cn
匣	匣.cn
匪	匪.cn
匹	匹.cn
匾	匾.cn
匿	匿.cn
半	半.cn
卑	卑.cn
卒	卒.cn
南	南.cn
博	博.cn
卜	卜.cn
卞	卞.cn
卯	卯.cn
印	印.cn
即	即.cn
卵	卵.cn
卷	卷.cn
卿	卿.cn
原	原.cn
厥	厥.cn
去	去.cn
及	及.cn
反	反.cn
取	取.cn
叛	叛.cn
叟	叟.cn
迭	迭.cn
口	口.cn
叫	叫.cn
叭	叭.cn
台	台.cn
叵	叵.cn
吆	吆.cn
吊	吊.cn
名	名.cn
吝	吝.cn
吟	吟.cn
吨	吨.cn
吩	吩.cn
含	含.cn
吭	吭.cn
吮	吮.cn
吵	吵.cn
吸	吸.cn
吹	吹.cn
呀	呀.cn
呈	呈.cn
呤	呤.cn
呦	呦.cn
呱	呱.cn
呶	呶.cn
呸	呸.cn
咂	咂.cn
咄	咄.cn
和	和.cn
咎	咎.cn
咦	咦.cn
咨	咨.cn
咬	咬.cn
咳	咳.cn
哀	哀.cn
哎	哎.cn
哏	哏.cn
哨	哨.cn
哪	哪.cn
哼	哼.cn
哽	哽.cn
唁	唁.cn
唆	唆.cn
唇	唇.cn
唉	唉.cn
唐	唐.cn
唚	唚.cn
唧	唧.cn
唪	唪.cn
唬	唬.cn
售	售.cn
唯	唯.cn
唳	唳.cn
唷	唷.cn
念	念.cn
唼	唼.cn
唾	唾.cn
啁	啁.cn
啄	啄.cn
商	商.cn
啐	啐.cn
喋	喋.cn
啕	啕.cn
啖	啖.cn
啡	啡.cn
啦	啦.cn
啻	啻.cn
啼	啼.cn
啾	啾.cn
喀	喀.cn
喂	喂.cn
喈	喈.cn
喑	喑.cn
喔	喔.cn
喘	喘.cn
喙	喙.cn
喜	喜.cn
喝	喝.cn
喧	喧.cn
喨	喨.cn
喱	喱.cn
喳	喳.cn
喵	喵.cn
嗄	嗄.cn
嗉	嗉.cn
嗌	嗌.cn
嗍	嗍.cn
嗑	嗑.cn
嗔	嗔.cn
嗖	嗖.cn
嗝	嗝.cn
嗟	嗟.cn
嗡	嗡.cn
嗣	嗣.cn
嗤	嗤.cn
嗦	嗦.cn
索	索.cn
嗨	嗨.cn
嗷	嗷.cn
嗽	嗽.cn
嗾	嗾.cn
嘀	嘀.cn
嘁	嘁.cn
嘈	嘈.cn
嘐	嘐.cn
嘛	嘛.cn
嘟	嘟.cn
都	都.cn
嘬	嘬.cn
嘲	嘲.cn
嘴	嘴.cn
噌	噌.cn
撅	撅.cn
噙	噙.cn
噚	噚.cn
噢	噢.cn
噫	噫.cn
噱	噱.cn
噶	噶.cn
宁	宁.cn
嚅	嚅.cn
嚆	嚆.cn
嚌	嚌.cn
嚎	嚎.cn
嚏	嚏.cn
嚷	嚷.cn
嚼	嚼.cn
囊	囊.cn
囔	囔.cn
囚	囚.cn
四	四.cn
回	回.cn
因	因.cn
囡	囡.cn
囤	囤.cn
困	困.cn
囹	囹.cn
圈	圈.cn
圉	圉.cn
圊	圊.cn
圜	圜.cn
在	在.cn
圬	圬.cn
圾	圾.cn
均	均.cn
坊	坊.cn
坌	坌.cn
坎	坎.cn
坏	坏.cn
坑	坑.cn
坨	坨.cn
坪	坪.cn
坳	坳.cn
坶	坶.cn
坻	坻.cn
垂	垂.cn
垃	垃.cn
垓	垓.cn
垛	垛.cn
垠	垠.cn
垤	垤.cn
垮	垮.cn
垸	垸.cn
埃	埃.cn
埏	埏.cn
埒	埒.cn
埕	埕.cn
埠	埠.cn
埰	埰.cn
埴	埴.cn
埸	埸.cn
培	培.cn
埽	埽.cn
堀	堀.cn
堆	堆.cn
堉	堉.cn
堙	堙.cn
堞	堞.cn
堰	堰.cn
堵	堵.cn
塌	塌.cn
塍	塍.cn
塑	塑.cn
塘	塘.cn
塞	塞.cn
塥	塥.cn
填	填.cn
塾	塾.cn
墀	墀.cn
墁	墁.cn
境	境.cn
墉	墉.cn
墓	墓.cn
增	增.cn
墟	墟.cn
墩	墩.cn
敦	敦.cn
墼	墼.cn
壁	壁.cn
壅	壅.cn
壈	壈.cn
壕	壕.cn
壤	壤.cn
夏	夏.cn
夔	夔.cn
夕	夕.cn
外	外.cn
多	多.cn
夜	夜.cn
夤	夤.cn
天	天.cn
太	太.cn
夷	夷.cn
夸	夸.cn
奉	奉.cn
奏	奏.cn
契	契.cn
奕	奕.cn
套	套.cn
奘	奘.cn
奚	奚.cn
奠	奠.cn
奢	奢.cn
女	女.cn
奴	奴.cn
奶	奶.cn
奸	奸.cn
她	她.cn
奼	奼.cn
好	好.cn
妁	妁.cn
如	如.cn
妃	妃.cn
妄	妄.cn
妊	妊.cn
妍	妍.cn
妒	妒.cn
妓	妓.cn
妖	妖.cn
妗	妗.cn
妙	妙.cn
妞	妞.cn
妣	妣.cn
妤	妤.cn
妥	妥.cn
妨	妨.cn
妮	妮.cn
妯	妯.cn
妲	妲.cn
妹	妹.cn
妻	妻.cn
妾	妾.cn
姅	姅.cn
姆	姆.cn
姊	姊.cn
始	始.cn
姐	姐.cn
姑	姑.cn
姒	姒.cn
姓	姓.cn
委	委.cn
姘	姘.cn
姚	姚.cn
姜	姜.cn
姝	姝.cn
姣	姣.cn
姥	姥.cn
姨	姨.cn
姬	姬.cn
姻	姻.cn
姿	姿.cn
威	威.cn
娃	娃.cn
娉	娉.cn
娌	娌.cn
娑	娑.cn
娓	娓.cn
娘	娘.cn
娜	娜.cn
娟	娟.cn
娠	娠.cn
娣	娣.cn
娥	娥.cn
娩	娩.cn
娶	娶.cn
娼	娼.cn
婀	婀.cn
婆	婆.cn
婉	婉.cn
婊	婊.cn
婕	婕.cn
婚	婚.cn
婢	婢.cn
婧	婧.cn
婪	婪.cn
淫	淫.cn
婷	婷.cn
婺	婺.cn
婿	婿.cn
媒	媒.cn
媚	媚.cn
媛	媛.cn
媲	媲.cn
媳	媳.cn
媵	媵.cn
媸	媸.cn
媾	媾.cn
愧	愧.cn
嫁	嫁.cn
嫂	嫂.cn
嫉	嫉.cn
忌	忌.cn
嫌	嫌.cn
嫖	嫖.cn
嫘	嫘.cn
嫜	嫜.cn
嫠	嫠.cn
嫡	嫡.cn
嫣	嫣.cn
嫦	嫦.cn
嫩	嫩.cn
嫫	嫫.cn
嬉	嬉.cn
嬖	嬖.cn
嬗	嬗.cn
嬲	嬲.cn
嬴	嬴.cn
孀	孀.cn
孕	孕.cn
字	字.cn
存	存.cn
孚	孚.cn
孤	孤.cn
孥	孥.cn
孩	孩.cn
孬	孬.cn
孰	孰.cn
孳	孳.cn
孵	孵.cn
孺	孺.cn
孽	孽.cn
它	它.cn
宄	宄.cn
宅	宅.cn
宇	宇.cn
守	守.cn
安	安.cn
宋	宋.cn
完	完.cn
宏	宏.cn
宓	宓.cn
宕	宕.cn
宗	宗.cn
官	官.cn
宙	宙.cn
定	定.cn
宛	宛.cn
宜	宜.cn
客	客.cn
宣	宣.cn
室	室.cn
宥	宥.cn
宦	宦.cn
宰	宰.cn
害	害.cn
宴	宴.cn
宵	宵.cn
宸	宸.cn
容	容.cn
宿	宿.cn
采	采.cn
寂	寂.cn
寄	寄.cn
寅	寅.cn
密	密.cn
寇	寇.cn
富	富.cn
寐	寐.cn
寒	寒.cn
寓	寓.cn
置	置.cn
寞	寞.cn
察	察.cn
寡	寡.cn
寤	寤.cn
寥	寥.cn
寨	寨.cn
寮	寮.cn
寰	寰.cn
射	射.cn
尊	尊.cn
小	小.cn
少	少.cn
尖	尖.cn
尢	尢.cn
尤	尤.cn
尬	尬.cn
就	就.cn
屁	屁.cn
居	居.cn
屈	屈.cn
屋	屋.cn
屏	屏.cn
屑	屑.cn
展	展.cn
屝	屝.cn
屠	屠.cn
屣	屣.cn
履	履.cn
屮	屮.cn
屯	屯.cn
山	山.cn
屹	屹.cn
屺	屺.cn
岈	岈.cn
岌	岌.cn
岍	岍.cn
岐	岐.cn
岑	岑.cn
岔	岔.cn
岢	岢.cn
岣	岣.cn
岩	岩.cn
岫	岫.cn
岬	岬.cn
岭	岭.cn
岱	岱.cn
岳	岳.cn
岵	岵.cn
岷	岷.cn
岸	岸.cn
峋	峋.cn
峒	峒.cn
峙	峙.cn
峨	峨.cn
峪	峪.cn
峭	峭.cn
峰	峰.cn
峻	峻.cn
崁	崁.cn
崆	崆.cn
崇	崇.cn
崎	崎.cn
昆	昆.cn
崔	崔.cn
崖	崖.cn
崛	崛.cn
崞	崞.cn
崤	崤.cn
崦	崦.cn
崧	崧.cn
崩	崩.cn
崴	崴.cn
崽	崽.cn
嵇	嵇.cn
嵊	嵊.cn
嵋	嵋.cn
嵌	嵌.cn
嵩	嵩.cn
嵫	嵫.cn
嵬	嵬.cn
嵯	嵯.cn
嶂	嶂.cn
嶙	嶙.cn
嶝	嶝.cn
嶮	嶮.cn
嶷	嶷.cn
巉	巉.cn
巍	巍.cn
巡	巡.cn
巧	巧.cn
巨	巨.cn
差	差.cn
巽	巽.cn
市	市.cn
帑	帑.cn
帘	帘.cn
帚	帚.cn
帛	帛.cn
帝	帝.cn
帟	帟.cn
席	席.cn
帷	帷.cn
幄	幄.cn
幕	幕.cn
幛	幛.cn
幢	幢.cn
邦	邦.cn
平	平.cn
幻	幻.cn
幼	幼.cn
幽	幽.cn
庀	庀.cn
庄	庄.cn
庇	庇.cn
床	床.cn
庋	庋.cn
序	序.cn
底	底.cn
庖	庖.cn
店	店.cn
庚	庚.cn
府	府.cn
庠	庠.cn
庥	庥.cn
度	度.cn
座	座.cn
庭	庭.cn
庳	庳.cn
庵	庵.cn
庶	庶.cn
康	康.cn
庸	庸.cn
庹	庹.cn
庾	庾.cn
廉	廉.cn
廊	廊.cn
廑	廑.cn
廒	廒.cn
廓	廓.cn
廖	廖.cn
廛	廛.cn
廨	廨.cn
延	延.cn
廷	廷.cn
建	建.cn
迠	迠.cn
弁	弁.cn
异	异.cn
弈	弈.cn
弊	弊.cn
弓	弓.cn
引	引.cn
弗	弗.cn
弘	弘.cn
弛	弛.cn
弟	弟.cn
弦	弦.cn
弧	弧.cn
弩	弩.cn
弭	弭.cn
弱	弱.cn
弼	弼.cn
彀	彀.cn
彖	彖.cn
彗	彗.cn
彘	彘.cn
彝	彝.cn
彤	彤.cn
彩	彩.cn
彪	彪.cn
彰	彰.cn
影	影.cn
彷	彷.cn
役	役.cn
待	待.cn
很	很.cn
徒	徒.cn
得	得.cn
徘	徘.cn
徙	徙.cn
徜	徜.cn
徬	徬.cn
徭	徭.cn
微	微.cn
德	德.cn
徽	徽.cn
心	心.cn
必	必.cn
忍	忍.cn
忐	忐.cn
忑	忑.cn
忒	忒.cn
志	志.cn
忘	忘.cn
忙	忙.cn
忝	忝.cn
忠	忠.cn
忪	忪.cn
忭	忭.cn
忱	忱.cn
忸	忸.cn
忽	忽.cn
忿	忿.cn
怀	怀.cn
怎	怎.cn
怒	怒.cn
怜	怜.cn
思	思.cn
怠	怠.cn
怡	怡.cn
急	急.cn
怦	怦.cn
怨	怨.cn
怫	怫.cn
怯	怯.cn
怵	怵.cn
恁	恁.cn
恃	恃.cn
恐	恐.cn
恕	恕.cn
恙	恙.cn
恚	恚.cn
恝	恝.cn
恢	恢.cn
恣	恣.cn
恧	恧.cn
恨	恨.cn
恩	恩.cn
恪	恪.cn
息	息.cn
恿	恿.cn
悄	悄.cn
悉	悉.cn
悌	悌.cn
悔	悔.cn
悛	悛.cn
悠	悠.cn
患	患.cn
您	您.cn
悱	悱.cn
悲	悲.cn
悴	悴.cn
悻	悻.cn
情	情.cn
惆	惆.cn
惇	惇.cn
惊	惊.cn
惋	惋.cn
惑	惑.cn
惘	惘.cn
惚	惚.cn
惝	惝.cn
惟	惟.cn
惠	惠.cn
惦	惦.cn
想	想.cn
惴	惴.cn
蠢	蠢.cn
惹	惹.cn
愀	愀.cn
愁	愁.cn
愆	愆.cn
愈	愈.cn
愉	愉.cn
愍	愍.cn
愎	愎.cn
意	意.cn
愒	愒.cn
愕	愕.cn
愚	愚.cn
感	感.cn
愣	愣.cn
楞	楞.cn
愫	愫.cn
愿	愿.cn
殷	殷.cn
慈	慈.cn
慊	慊.cn
慌	慌.cn
慎	慎.cn
慕	慕.cn
慝	慝.cn
慧	慧.cn
慨	慨.cn
慰	慰.cn
慵	慵.cn
慷	慷.cn
欲	欲.cn
憋	憋.cn
憎	憎.cn
憔	憔.cn
憝	憝.cn
憧	憧.cn
憨	憨.cn
憩	憩.cn
憬	憬.cn
憾	憾.cn
懈	懈.cn
懊	懊.cn
懋	懋.cn
蒙	蒙.cn
懦	懦.cn
懿	懿.cn
戌	戌.cn
戍	戍.cn
戎	戎.cn
戕	戕.cn
戡	戡.cn
戢	戢.cn
戤	戤.cn
截	截.cn
戮	戮.cn
戳	戳.cn
戴	戴.cn
戽	戽.cn
戾	戾.cn
房	房.cn
所	所.cn
扁	扁.cn
扃	扃.cn
扇	扇.cn
扈	扈.cn
扉	扉.cn
才	才.cn
扒	扒.cn
扔	扔.cn
扠	扠.cn
扭	扭.cn
扮	扮.cn
扰	扰.cn
扳	扳.cn
批	批.cn
抄	抄.cn
抆	抆.cn
抑	抑.cn
投	投.cn
抗	抗.cn
抨	抨.cn
抬	抬.cn
抵	抵.cn
抿	抿.cn
拂	拂.cn
拄	拄.cn
拇	拇.cn
拉	拉.cn
拌	拌.cn
拎	拎.cn
拒	拒.cn
拔	拔.cn
拗	拗.cn
拙	拙.cn
拚	拚.cn
拜	拜.cn
拳	拳.cn
拴	拴.cn
拷	拷.cn
挈	挈.cn
按	按.cn
挎	挎.cn
挑	挑.cn
挖	挖.cn
挨	挨.cn
挪	挪.cn
振	振.cn
挲	挲.cn
挺	挺.cn
救	救.cn
捉	捉.cn
捋	捋.cn
捌	捌.cn
捎	捎.cn
捧	捧.cn
捩	捩.cn
捶	捶.cn
捻	捻.cn
掀	掀.cn
掂	掂.cn
掊	掊.cn
掌	掌.cn
掏	掏.cn
掐	掐.cn
排	排.cn
掖	掖.cn
掘	掘.cn
掠	掠.cn
探	探.cn
掣	掣.cn
接	接.cn
控	控.cn
推	推.cn
掭	掭.cn
掮	掮.cn
掰	掰.cn
碰	碰.cn
掾	掾.cn
揄	揄.cn
揍	揍.cn
揎	揎.cn
揖	揖.cn
揠	揠.cn
握	握.cn
揣	揣.cn
揩	揩.cn
揭	揭.cn
揲	揲.cn
援	援.cn
揶	揶.cn
构	构.cn
榷	榷.cn
搋	搋.cn
搌	搌.cn
搐	搐.cn
搓	搓.cn
搔	搔.cn
搛	搛.cn
搜	搜.cn
搞	搞.cn
搠	搠.cn
搦	搦.cn
搧	搧.cn
搪	搪.cn
搬	搬.cn
搴	搴.cn
搽	搽.cn
榨	榨.cn
搿	搿.cn
摁	摁.cn
摒	摒.cn
摔	摔.cn
摘	摘.cn
摞	摞.cn
摧	摧.cn
摩	摩.cn
摭	摭.cn
撇	撇.cn
撉	撉.cn
撖	撖.cn
撙	撙.cn
撝	撝.cn
撞	撞.cn
撢	撢.cn
撤	撤.cn
撬	撬.cn
撮	撮.cn
撼	撼.cn
擂	擂.cn
擅	擅.cn
擎	擎.cn
擐	擐.cn
擒	擒.cn
擗	擗.cn
擘	擘.cn
擢	擢.cn
擦	擦.cn
擭	擭.cn
攀	攀.cn
攉	攉.cn
攘	攘.cn
攥	攥.cn
攫	攫.cn
攮	攮.cn
收	收.cn
考	考.cn
改	改.cn
放	放.cn
敏	敏.cn
敖	敖.cn
敝	敝.cn
敞	敞.cn
敢	敢.cn
敲	敲.cn
敷	敷.cn
文	文.cn
斌	斌.cn
斐	斐.cn
斑	斑.cn
斛	斛.cn
新	新.cn
方	方.cn
施	施.cn
旁	旁.cn
旗	旗.cn
旃	旃.cn
旄	旄.cn
旅	旅.cn
旆	旆.cn
旋	旋.cn
旌	旌.cn
旎	旎.cn
族	族.cn
旒	旒.cn
旖	旖.cn
旡	旡.cn
既	既.cn
旦	旦.cn
昀	昀.cn
昂	昂.cn
昊	昊.cn
昏	昏.cn
昝	昝.cn
昤	昤.cn
春	春.cn
昧	昧.cn
昱	昱.cn
昴	昴.cn
昶	昶.cn
晏	晏.cn
晦	晦.cn
晨	晨.cn
景	景.cn
晴	晴.cn
晷	晷.cn
暗	暗.cn
晾	晾.cn
暄	暄.cn
暍	暍.cn
暑	暑.cn
暖	暖.cn
暝	暝.cn
暮	暮.cn
暴	暴.cn
暹	暹.cn
暾	暾.cn
曙	曙.cn
曚	曚.cn
曜	曜.cn
曝	曝.cn
曦	曦.cn
曩	曩.cn
曷	曷.cn
曾	曾.cn
最	最.cn
朔	朔.cn
朕	朕.cn
朗	朗.cn
望	望.cn
朦	朦.cn
木	木.cn
本	本.cn
朵	朵.cn
朽	朽.cn
杈	杈.cn
杖	杖.cn
杗	杗.cn
杪	杪.cn
杭	杭.cn
杴	杴.cn
松	松.cn
板	板.cn
极	极.cn
枇	枇.cn
枋	枋.cn
枕	枕.cn
枘	枘.cn
枟	枟.cn
枰	枰.cn
枳	枳.cn
枵	枵.cn
柁	柁.cn
柃	柃.cn
柜	柜.cn
柢	柢.cn
柩	柩.cn
柳	柳.cn
柿	柿.cn
栓	栓.cn
校	校.cn
栩	栩.cn
栲	栲.cn
核	核.cn
根	根.cn
桀	桀.cn
桃	桃.cn
框	框.cn
案	案.cn
桉	桉.cn
桎	桎.cn
桓	桓.cn
桫	桫.cn
桴	桴.cn
桷	桷.cn
梁	梁.cn
梃	梃.cn
梅	梅.cn
梆	梆.cn
梏	梏.cn
梓	梓.cn
梡	梡.cn
梢	梢.cn
梭	梭.cn
梯	梯.cn
梱	梱.cn
梳	梳.cn
棍	棍.cn
棒	棒.cn
棕	棕.cn
棰	棰.cn
棱	棱.cn
棺	棺.cn
棻	棻.cn
棼	棼.cn
椋	椋.cn
植	植.cn
椎	椎.cn
碇	碇.cn
椰	椰.cn
椴	椴.cn
椹	椹.cn
椽	椽.cn
椿	椿.cn
楂	楂.cn
楔	楔.cn
楗	楗.cn
楚	楚.cn
楦	楦.cn
楫	楫.cn
楮	楮.cn
楱	楱.cn
楷	楷.cn
楹	楹.cn
概	概.cn
榍	榍.cn
榔	榔.cn
榕	榕.cn
榛	榛.cn
榜	榜.cn
榣	榣.cn
榧	榧.cn
榫	榫.cn
榭	榭.cn
榱	榱.cn
榴	榴.cn
榻	榻.cn
槁	槁.cn
槃	槃.cn
槊	槊.cn
槌	槌.cn
槎	槎.cn
槐	槐.cn
槤	槤.cn
槲	槲.cn
樗	樗.cn
樟	樟.cn
樨	樨.cn
樵	樵.cn
樽	樽.cn
樾	樾.cn
橄	橄.cn
橇	橇.cn
橐	橐.cn
橘	橘.cn
橙	橙.cn
橛	橛.cn
橡	橡.cn
檀	檀.cn
檄	檄.cn
檎	檎.cn
檐	檐.cn
沿	沿.cn
檑	檑.cn
檗	檗.cn
檠	檠.cn
檬	檬.cn
欐	欐.cn
欠	欠.cn
次	次.cn
欣	欣.cn
欷	欷.cn
欹	欹.cn
欺	欺.cn
款	款.cn
歃	歃.cn
歆	歆.cn
歇	歇.cn
歉	歉.cn
歌	歌.cn
歙	歙.cn
歜	歜.cn
步	步.cn
死	死.cn
殆	殆.cn
殍	殍.cn
殖	殖.cn
殛	殛.cn
殰	殰.cn
殳	殳.cn
段	段.cn
殿	殿.cn
毅	毅.cn
毋	毋.cn
母	母.cn
每	每.cn
毒	毒.cn
毓	毓.cn
比	比.cn
毖	毖.cn
毗	毗.cn
毚	毚.cn
毛	毛.cn
毫	毫.cn
球	球.cn
毯	毯.cn
毳	毳.cn
毹	毹.cn
毽	毽.cn
氅	氅.cn
氍	氍.cn
氏	氏.cn
氐	氐.cn
民	民.cn
氓	氓.cn
氖	氖.cn
氙	氙.cn
氛	氛.cn
氟	氟.cn
氦	氦.cn
氨	氨.cn
氮	氮.cn
氯	氯.cn
氰	氰.cn
泛	泛.cn
汊	汊.cn
汍	汍.cn
汕	汕.cn
污	污.cn
汛	汛.cn
汝	汝.cn
汲	汲.cn
汴	汴.cn
汶	汶.cn
汾	汾.cn
沁	沁.cn
沄	沄.cn
沆	沆.cn
沈	沈.cn
沋	沋.cn
沌	沌.cn
沍	沍.cn
沏	沏.cn
沔	沔.cn
沘	沘.cn
沙	沙.cn
沛	沛.cn
沭	沭.cn
沱	沱.cn
沸	沸.cn
治	治.cn
泄	泄.cn
泅	泅.cn
泓	泓.cn
法	法.cn
泖	泖.cn
泜	泜.cn
溯	溯.cn
泞	泞.cn
泠	泠.cn
泣	泣.cn
泫	泫.cn
泮	泮.cn
泯	泯.cn
泰	泰.cn
洚	洚.cn
洰	洰.cn
洱	洱.cn
洳	洳.cn
派	派.cn
流	流.cn
浚	浚.cn
浣	浣.cn
浪	浪.cn
浮	浮.cn
海	海.cn
浸	浸.cn
浼	浼.cn
消	消.cn
涉	涉.cn
涊	涊.cn
涎	涎.cn
涔	涔.cn
涕	涕.cn
涪	涪.cn
涫	涫.cn
液	液.cn
涵	涵.cn
涿	涿.cn
淀	淀.cn
淌	淌.cn
淘	淘.cn
淙	淙.cn
淞	淞.cn
淤	淤.cn
淩	淩.cn
淬	淬.cn
淮	淮.cn
深	深.cn
淳	淳.cn
混	混.cn
添	添.cn
渺	渺.cn
渚	渚.cn
渝	渝.cn
渠	渠.cn
渡	渡.cn
渣	渣.cn
渥	渥.cn
渫	渫.cn
渲	渲.cn
渴	渴.cn
游	游.cn
湃	湃.cn
湍	湍.cn
湓	湓.cn
湔	湔.cn
湛	湛.cn
湣	湣.cn
湮	湮.cn
湲	湲.cn
溉	溉.cn
溏	溏.cn
源	源.cn
溘	溘.cn
溜	溜.cn
溟	溟.cn
溢	溢.cn
溪	溪.cn
溱	溱.cn
溶	溶.cn
溺	溺.cn
溽	溽.cn
滂	滂.cn
滇	滇.cn
滋	滋.cn
滏	滏.cn
滑	滑.cn
滓	滓.cn
滔	滔.cn
滕	滕.cn
滴	滴.cn
漆	漆.cn
漉	漉.cn
漓	漓.cn
演	演.cn
漩	漩.cn
漯	漯.cn
漱	漱.cn
漳	漳.cn
漶	漶.cn
潢	潢.cn
潲	潲.cn
潸	潸.cn
潼	潼.cn
澈	澈.cn
澉	澉.cn
澎	澎.cn
澳	澳.cn
澴	澴.cn
澶	澶.cn
澹	澹.cn
激	激.cn
濂	濂.cn
濉	濉.cn
濠	濠.cn
濡	濡.cn
濩	濩.cn
濯	濯.cn
瀇	瀇.cn
瀑	瀑.cn
瀚	瀚.cn
瀛	瀛.cn
灌	灌.cn
灞	灞.cn
灠	灠.cn
灰	灰.cn
灸	灸.cn
炊	炊.cn
炎	炎.cn
炒	炒.cn
炖	炖.cn
炫	炫.cn
炬	炬.cn
炭	炭.cn
炱	炱.cn
炳	炳.cn
炷	炷.cn
烤	烤.cn
烷	烷.cn
烹	烹.cn
烽	烽.cn
焉	焉.cn
焙	焙.cn
焚	焚.cn
焜	焜.cn
焦	焦.cn
焰	焰.cn
煜	煜.cn
煞	煞.cn
煤	煤.cn
煨	煨.cn
煮	煮.cn
煲	煲.cn
煽	煽.cn
熄	熄.cn
熊	熊.cn
熔	熔.cn
熙	熙.cn
熟	熟.cn
熠	熠.cn
熬	熬.cn
燉	燉.cn
磷	磷.cn
燠	燠.cn
粲	粲.cn
燧	燧.cn
燮	燮.cn
燸	燸.cn
耀	耀.cn
爆	爆.cn
爝	爝.cn
爰	爰.cn
爵	爵.cn
爸	爸.cn
爹	爹.cn
爻	爻.cn
爿	爿.cn
版	版.cn
牒	牒.cn
牖	牖.cn
牙	牙.cn
牟	牟.cn
牢	牢.cn
牿	牿.cn
犀	犀.cn
犍	犍.cn
犒	犒.cn
狁	狁.cn
狃	狃.cn
狄	狄.cn
狐	狐.cn
狒	狒.cn
狠	狠.cn
狡	狡.cn
狩	狩.cn
狴	狴.cn
狺	狺.cn
狻	狻.cn
狼	狼.cn
猜	猜.cn
猝	猝.cn
猥	猥.cn
猷	猷.cn
猾	猾.cn
猿	猿.cn
獍	獍.cn
獐	獐.cn
獒	獒.cn
獗	獗.cn
獬	獬.cn
獾	獾.cn
玄	玄.cn
玆	玆.cn
率	率.cn
玟	玟.cn
玢	玢.cn
玲	玲.cn
珊	珊.cn
珥	珥.cn
琅	琅.cn
琉	琉.cn
琊	琊.cn
璃	璃.cn
琛	琛.cn
琢	琢.cn
琥	琥.cn
琨	琨.cn
琬	琬.cn
琮	琮.cn
琯	琯.cn
琰	琰.cn
琴	琴.cn
琵	琵.cn
琶	琶.cn
瑗	瑗.cn
瑜	瑜.cn
瑞	瑞.cn
瑟	瑟.cn
瑭	瑭.cn
瑰	瑰.cn
璀	璀.cn
璁	璁.cn
离	离.cn
璇	璇.cn
璋	璋.cn
璘	璘.cn
璜	璜.cn
璟	璟.cn
璧	璧.cn
璩	璩.cn
璺	璺.cn
瓖	瓖.cn
瓜	瓜.cn
瓞	瓞.cn
瓠	瓠.cn
瓢	瓢.cn
瓣	瓣.cn
瓤	瓤.cn
瓦	瓦.cn
瓩	瓩.cn
瓮	瓮.cn
瓴	瓴.cn
瓶	瓶.cn
瓷	瓷.cn
磁	磁.cn
瓿	瓿.cn
甄	甄.cn
甍	甍.cn
甏	甏.cn
甑	甑.cn
甓	甓.cn
甭	甭.cn
甯	甯.cn
町	町.cn
畈	畈.cn
界	界.cn
畏	畏.cn
畔	畔.cn
畚	畚.cn
畜	畜.cn
畹	畹.cn
畿	畿.cn
疆	疆.cn
疏	疏.cn
疔	疔.cn
疙	疙.cn
疚	疚.cn
疝	疝.cn
疢	疢.cn
疣	疣.cn
疤	疤.cn
疥	疥.cn
疫	疫.cn
疰	疰.cn
疲	疲.cn
疳	疳.cn
疵	疵.cn
疸	疸.cn
疹	疹.cn
疼	疼.cn
疽	疽.cn
疾	疾.cn
痱	痱.cn
痂	痂.cn
痄	痄.cn
病	病.cn
症	症.cn
痊	痊.cn
痍	痍.cn
痒	痒.cn
痔	痔.cn
痕	痕.cn
痘	痘.cn
痛	痛.cn
痞	痞.cn
痠	痠.cn
痢	痢.cn
痣	痣.cn
痤	痤.cn
痦	痦.cn
痧	痧.cn
痰	痰.cn
痲	痲.cn
痴	痴.cn
痹	痹.cn
痼	痼.cn
痿	痿.cn
瘀	瘀.cn
瘁	瘁.cn
瘃	瘃.cn
瘊	瘊.cn
瘌	瘌.cn
瘐	瘐.cn
瘕	瘕.cn
瘙	瘙.cn
瘛	瘛.cn
瘟	瘟.cn
瘠	瘠.cn
瘢	瘢.cn
瘤	瘤.cn
瘥	瘥.cn
瘦	瘦.cn
瘩	瘩.cn
瘭	瘭.cn
瘰	瘰.cn
瘳	瘳.cn
瘴	瘴.cn
瘵	瘵.cn
瘸	瘸.cn
瘼	瘼.cn
癃	癃.cn
癌	癌.cn
癖	癖.cn
癜	癜.cn
癸	癸.cn
的	的.cn
皆	皆.cn
皈	皈.cn
皎	皎.cn
皖	皖.cn
皴	皴.cn
盆	盆.cn
盈	盈.cn
益	益.cn
盍	盍.cn
盔	盔.cn
盥	盥.cn
盲	盲.cn
直	直.cn
盹	盹.cn
盼	盼.cn
省	省.cn
眄	眄.cn
眇	眇.cn
眈	眈.cn
眙	眙.cn
真	真.cn
眠	眠.cn
眨	眨.cn
眩	眩.cn
眶	眶.cn
眷	眷.cn
眸	眸.cn
眼	眼.cn
睇	睇.cn
睛	睛.cn
睡	睡.cn
睢	睢.cn
督	督.cn
睦	睦.cn
睬	睬.cn
睹	睹.cn
瞌	瞌.cn
瞍	瞍.cn
瞎	瞎.cn
瞑	瞑.cn
瞠	瞠.cn
瞥	瞥.cn
瞧	瞧.cn
瞬	瞬.cn
瞰	瞰.cn
瞳	瞳.cn
瞵	瞵.cn
瞻	瞻.cn
瞿	瞿.cn
矍	矍.cn
矗	矗.cn
矜	矜.cn
矣	矣.cn
矧	矧.cn
矩	矩.cn
矮	矮.cn
砂	砂.cn
砉	砉.cn
砌	砌.cn
砍	砍.cn
砑	砑.cn
砒	砒.cn
砝	砝.cn
砣	砣.cn
砥	砥.cn
砩	砩.cn
砬	砬.cn
砭	砭.cn
砰	砰.cn
砱	砱.cn
砸	砸.cn
硝	硝.cn
硫	硫.cn
硭	硭.cn
确	确.cn
硿	硿.cn
碉	碉.cn
碌	碌.cn
碎	碎.cn
碓	碓.cn
碗	碗.cn
碚	碚.cn
碟	碟.cn
碡	碡.cn
碣	碣.cn
碥	碥.cn
碲	碲.cn
碳	碳.cn
碾	碾.cn
磅	磅.cn
磋	磋.cn
磐	磐.cn
磔	磔.cn
磕	磕.cn
磨	磨.cn
磬	磬.cn
磲	磲.cn
磺	磺.cn
礁	礁.cn
礞	礞.cn
礤	礤.cn
社	社.cn
祀	祀.cn
祁	祁.cn
祅	祅.cn
祆	祆.cn
祇	祇.cn
祈	祈.cn
祉	祉.cn
祐	祐.cn
祓	祓.cn
秘	秘.cn
祖	祖.cn
祗	祗.cn
祚	祚.cn
祛	祛.cn
祜	祜.cn
祝	祝.cn
神	神.cn
祟	祟.cn
祠	祠.cn
祥	祥.cn
祧	祧.cn
祭	祭.cn
祺	祺.cn
祼	祼.cn
禊	禊.cn
福	福.cn
禚	禚.cn
禧	禧.cn
禳	禳.cn
禽	禽.cn
秀	秀.cn
私	私.cn
秋	秋.cn
秒	秒.cn
秕	秕.cn
秤	秤.cn
秦	秦.cn
秫	秫.cn
秭	秭.cn
稂	稂.cn
稃	稃.cn
程	程.cn
稍	稍.cn
稔	稔.cn
稚	稚.cn
稠	稠.cn
稨	稨.cn
稷	稷.cn
稹	稹.cn
稻	稻.cn
稼	稼.cn
稽	稽.cn
稿	稿.cn
穋	穋.cn
穗	穗.cn
穰	穰.cn
穴	穴.cn
究	究.cn
穸	穸.cn
穹	穹.cn
空	空.cn
穿	穿.cn
窀	窀.cn
突	突.cn
窄	窄.cn
窆	窆.cn
窈	窈.cn
窒	窒.cn
窕	窕.cn
窖	窖.cn
窗	窗.cn
窘	窘.cn
窟	窟.cn
窠	窠.cn
窨	窨.cn
窬	窬.cn
窳	窳.cn
窿	窿.cn
立	立.cn
站	站.cn
竟	竟.cn
章	章.cn
竣	竣.cn
童	童.cn
竦	竦.cn
竭	竭.cn
端	端.cn
笈	笈.cn
笞	笞.cn
笠	笠.cn
笫	笫.cn
第	第.cn
笸	笸.cn
筅	筅.cn
筌	筌.cn
筐	筐.cn
筠	筠.cn
管	管.cn
筲	筲.cn
筵	筵.cn
箍	箍.cn
箐	箐.cn
箜	箜.cn
箸	箸.cn
篆	篆.cn
篇	篇.cn
萹	萹.cn
篌	篌.cn
篙	篙.cn
篚	篚.cn
篝	篝.cn
篠	篠.cn
篡	篡.cn
篦	篦.cn
芘	芘.cn
篪	篪.cn
篱	篱.cn
篷	篷.cn
纂	纂.cn
簇	簇.cn
簋	簋.cn
簌	簌.cn
簏	簏.cn
蓑	蓑.cn
簧	簧.cn
簪	簪.cn
簿	簿.cn
籀	籀.cn
藤	藤.cn
粉	粉.cn
粒	粒.cn
粢	粢.cn
粥	粥.cn
粳	粳.cn
粹	粹.cn
粼	粼.cn
粽	粽.cn
精	精.cn
糖	糖.cn
糙	糙.cn
糜	糜.cn
糠	糠.cn
糨	糨.cn
糯	糯.cn
糸	糸.cn
紊	紊.cn
紘	紘.cn
素	素.cn
紫	紫.cn
累	累.cn
絅	絅.cn
絮	絮.cn
綞	綞.cn
綠	綠.cn
綦	綦.cn
綮	綮.cn
网	网.cn
緶	緶.cn
致	致.cn
縕	縕.cn
縯	縯.cn
縳	縳.cn
縻	縻.cn
縿	縿.cn
繁	繁.cn
繇	繇.cn
繈	繈.cn
繐	繐.cn
翻	翻.cn
繢	繢.cn
繨	繨.cn
繸	繸.cn
纇	纇.cn
纛	纛.cn
缶	缶.cn
缸	缸.cn
缺	缺.cn
罄	罄.cn
罅	罅.cn
罐	罐.cn
罔	罔.cn
罕	罕.cn
罪	罪.cn
署	署.cn
罹	罹.cn
罾	罾.cn
羌	羌.cn
羚	羚.cn
羝	羝.cn
羞	羞.cn
羡	羡.cn
羧	羧.cn
羯	羯.cn
羲	羲.cn
膻	膻.cn
羸	羸.cn
羹	羹.cn
羼	羼.cn
羽	羽.cn
羿	羿.cn
翁	翁.cn
翅	翅.cn
翊	翊.cn
翌	翌.cn
翎	翎.cn
翔	翔.cn
翕	翕.cn
翟	翟.cn
翠	翠.cn
翡	翡.cn
翥	翥.cn
翦	翦.cn
翩	翩.cn
翮	翮.cn
翰	翰.cn
翱	翱.cn
翳	翳.cn
翼	翼.cn
耄	耄.cn
者	者.cn
耋	耋.cn
而	而.cn
耍	耍.cn
耐	耐.cn
耔	耔.cn
耕	耕.cn
耖	耖.cn
耗	耗.cn
耘	耘.cn
耙	耙.cn
耜	耜.cn
耦	耦.cn
耨	耨.cn
耩	耩.cn
耪	耪.cn
耳	耳.cn
耵	耵.cn
耶	耶.cn
耷	耷.cn
耽	耽.cn
耿	耿.cn
聃	聃.cn
聆	聆.cn
聊	聊.cn
聒	聒.cn
聘	聘.cn
聚	聚.cn
聱	聱.cn
肆	肆.cn
肇	肇.cn
肓	肓.cn
肖	肖.cn
股	股.cn
肩	肩.cn
肪	肪.cn
肫	肫.cn
肭	肭.cn
肮	肮.cn
肱	肱.cn
育	育.cn
胍	胍.cn
胎	胎.cn
胖	胖.cn
胝	胝.cn
胤	胤.cn
胯	胯.cn
胰	胰.cn
胲	胲.cn
胸	胸.cn
胺	胺.cn
能	能.cn
脊	脊.cn
脘	脘.cn
脤	脤.cn
脬	脬.cn
腋	腋.cn
腐	腐.cn
腑	腑.cn
腓	腓.cn
腔	腔.cn
腕	腕.cn
腠	腠.cn
腧	腧.cn
腮	腮.cn
腰	腰.cn
腱	腱.cn
腹	腹.cn
腿	腿.cn
膀	膀.cn
膂	膂.cn
膈	膈.cn
膏	膏.cn
膣	膣.cn
膦	膦.cn
膺	膺.cn
臀	臀.cn
臂	臂.cn
臃	臃.cn
臆	臆.cn
裸	裸.cn
臣	臣.cn
臧	臧.cn
至	至.cn
臻	臻.cn
臿	臿.cn
舀	舀.cn
舂	舂.cn
舐	舐.cn
舔	舔.cn
舛	舛.cn
舜	舜.cn
舞	舞.cn
舟	舟.cn
舡	舡.cn
舢	舢.cn
舨	舨.cn
航	航.cn
舫	舫.cn
般	般.cn
舳	舳.cn
舴	舴.cn
舵	舵.cn
舶	舶.cn
舷	舷.cn
舸	舸.cn
船	船.cn
舺	舺.cn
艄	艄.cn
艇	艇.cn
艉	艉.cn
艋	艋.cn
艏	艏.cn
艘	艘.cn
艚	艚.cn
艟	艟.cn
艨	艨.cn
艮	艮.cn
良	良.cn
艴	艴.cn
艾	艾.cn
艿	艿.cn
芎	芎.cn
芒	芒.cn
芝	芝.cn
芟	芟.cn
芡	芡.cn
芨	芨.cn
芩	芩.cn
芬	芬.cn
芮	芮.cn
芯	芯.cn
芳	芳.cn
芸	芸.cn
芽	芽.cn
苒	苒.cn
苓	苓.cn
苔	苔.cn
苠	苠.cn
苡	苡.cn
苣	苣.cn
苤	苤.cn
苧	苧.cn
苳	苳.cn
苹	苹.cn
茁	茁.cn
茆	茆.cn
茇	茇.cn
茗	茗.cn
茛	茛.cn
茜	茜.cn
茨	茨.cn
茫	茫.cn
茬	茬.cn
茭	茭.cn
茶	茶.cn
茸	茸.cn
茹	茹.cn
茺	茺.cn
荃	荃.cn
荑	荑.cn
荒	荒.cn
荽	荽.cn
莎	莎.cn
莒	莒.cn
莓	莓.cn
莘	莘.cn
莛	莛.cn
莞	莞.cn
莠	莠.cn
莨	莨.cn
莩	莩.cn
菀	菀.cn
菁	菁.cn
菅	菅.cn
菇	菇.cn
菘	菘.cn
菜	菜.cn
菝	菝.cn
菟	菟.cn
菡	菡.cn
菩	菩.cn
菪	菪.cn
菰	菰.cn
菱	菱.cn
菲	菲.cn
萃	萃.cn
萄	萄.cn
萋	萋.cn
萍	萍.cn
萎	萎.cn
萏	萏.cn
萑	萑.cn
萱	萱.cn
萼	萼.cn
葚	葚.cn
葛	葛.cn
葬	葬.cn
葯	葯.cn
葳	葳.cn
葵	葵.cn
葶	葶.cn
葸	葸.cn
葺	葺.cn
蒂	蒂.cn
蒗	蒗.cn
蒡	蒡.cn
蒴	蒴.cn
蒹	蒹.cn
蒺	蒺.cn
蒿	蒿.cn
蓁	蓁.cn
蓄	蓄.cn
蓉	蓉.cn
蓊	蓊.cn
蓐	蓐.cn
蓓	蓓.cn
蓖	蓖.cn
蓬	蓬.cn
蓰	蓰.cn
蓼	蓼.cn
蓿	蓿.cn
蔂	蔂.cn
蔌	蔌.cn
蔑	蔑.cn
蔗	蔗.cn
蔟	蔟.cn
蔡	蔡.cn
蔫	蔫.cn
蔬	蔬.cn
麻	麻.cn
蔽	蔽.cn
藜	藜.cn
蕉	蕉.cn
蕖	蕖.cn
蕞	蕞.cn
蕤	蕤.cn
蕨	蕨.cn
蕹	蕹.cn
蕺	蕺.cn
蕻	蕻.cn
蕾	蕾.cn
薄	薄.cn
薅	薅.cn
薇	薇.cn
薏	薏.cn
薛	薛.cn
薜	薜.cn
薪	薪.cn
薯	薯.cn
薳	薳.cn
薷	薷.cn
薹	薹.cn
藏	藏.cn
藕	藕.cn
藿	藿.cn
蘑	蘑.cn
蘗	蘗.cn
蘧	蘧.cn
蘩	蘩.cn
蘸	蘸.cn
蘼	蘼.cn
虆	虆.cn
虍	虍.cn
虎	虎.cn
虐	虐.cn
虔	虔.cn
虞	虞.cn
虢	虢.cn
虻	虻.cn
蚊	蚊.cn
蚋	蚋.cn
蚌	蚌.cn
蚍	蚍.cn
蚓	蚓.cn
蚕	蚕.cn
蚜	蚜.cn
蚣	蚣.cn
蚤	蚤.cn
蚩	蚩.cn
蚴	蚴.cn
蚺	蚺.cn
蛀	蛀.cn
蛇	蛇.cn
蛉	蛉.cn
蛑	蛑.cn
蛟	蛟.cn
蛭	蛭.cn
蛸	蛸.cn
蜀	蜀.cn
蜃	蜃.cn
蜈	蜈.cn
蜉	蜉.cn
螂	螂.cn
蜒	蜒.cn
蜓	蜓.cn
蜚	蜚.cn
蜜	蜜.cn
蜣	蜣.cn
蝶	蝶.cn
蜩	蜩.cn
蜷	蜷.cn
霓	霓.cn
蜻	蜻.cn
蜿	蜿.cn
蝎	蝎.cn
蝓	蝓.cn
蝙	蝙.cn
蠕	蠕.cn
蝣	蝣.cn
蝤	蝤.cn
蝮	蝮.cn
螃	螃.cn
螅	螅.cn
螈	螈.cn
融	融.cn
螓	螓.cn
螗	螗.cn
螟	螟.cn
螭	螭.cn
螯	螯.cn
螺	螺.cn
螽	螽.cn
螿	螿.cn
蟀	蟀.cn
蟋	蟋.cn
蟓	蟓.cn
蟥	蟥.cn
蟪	蟪.cn
蟹	蟹.cn
蟾	蟾.cn
蠃	蠃.cn
蠊	蠊.cn
蠓	蠓.cn
蠖	蠖.cn
蠡	蠡.cn
蠲	蠲.cn
蠼	蠼.cn
衄	衄.cn
衢	衢.cn
衣	衣.cn
表	表.cn
衩	衩.cn
衫	衫.cn
衭	衭.cn
衰	衰.cn
衲	衲.cn
衷	衷.cn
衽	衽.cn
衾	衾.cn
衿	衿.cn
袁	袁.cn
袂	袂.cn
袈	袈.cn
袋	袋.cn
袍	袍.cn
袒	袒.cn
袖	袖.cn
袢	袢.cn
袤	袤.cn
被	被.cn
袱	袱.cn
袼	袼.cn
裁	裁.cn
裂	裂.cn
裎	裎.cn
裒	裒.cn
裔	裔.cn
裕	裕.cn
裘	裘.cn
裙	裙.cn
裟	裟.cn
裨	裨.cn
裯	裯.cn
裰	裰.cn
裱	裱.cn
裳	裳.cn
裴	裴.cn
裹	裹.cn
裼	裼.cn
裾	裾.cn
褂	褂.cn
褊	褊.cn
褐	褐.cn
褒	褒.cn
褓	褓.cn
褕	褕.cn
褙	褙.cn
褚	褚.cn
褡	褡.cn
褥	褥.cn
褪	褪.cn
褫	褫.cn
褰	褰.cn
褶	褶.cn
褽	褽.cn
襁	襁.cn
襄	襄.cn
襞	襞.cn
襟	襟.cn
襦	襦.cn
襻	襻.cn
西	西.cn
要	要.cn
覃	覃.cn
覆	覆.cn
角	角.cn
觖	觖.cn
觚	觚.cn
觜	觜.cn
解	解.cn
觥	觥.cn
触	触.cn
觫	觫.cn
觳	觳.cn
觼	觼.cn
言	言.cn
訇	訇.cn
訏	訏.cn
訑	訑.cn
訒	訒.cn
証	証.cn
訾	訾.cn
詈	詈.cn
詨	詨.cn
詹	詹.cn
詻	詻.cn
誏	誏.cn
誓	誓.cn
誧	誧.cn
誾	誾.cn
謇	謇.cn
謦	謦.cn
譅	譅.cn
警	警.cn
譬	譬.cn
譸	譸.cn
豁	豁.cn
豌	豌.cn
豕	豕.cn
豚	豚.cn
豢	豢.cn
豪	豪.cn
豫	豫.cn
豳	豳.cn
貔	貔.cn
貙	貙.cn
賰	賰.cn
赧	赧.cn
赭	赭.cn
走	走.cn
赳	赳.cn
赴	赴.cn
起	起.cn
超	超.cn
越	越.cn
趑	趑.cn
趟	趟.cn
趣	趣.cn
趴	趴.cn
趵	趵.cn
趹	趹.cn
趿	趿.cn
跆	跆.cn
跋	跋.cn
跎	跎.cn
跚	跚.cn
距	距.cn
跟	跟.cn
跤	跤.cn
跨	跨.cn
踩	踩.cn
跽	跽.cn
踉	踉.cn
踡	踡.cn
踣	踣.cn
逾	逾.cn
踱	踱.cn
踹	踹.cn
蹀	蹀.cn
蹁	蹁.cn
蹄	蹄.cn
蹇	蹇.cn
蹈	蹈.cn
蹉	蹉.cn
蹊	蹊.cn
蹋	蹋.cn
蹙	蹙.cn
蹦	蹦.cn
蹩	蹩.cn
蹭	蹭.cn
蹲	蹲.cn
蹴	蹴.cn
蹶	蹶.cn
躇	躇.cn
躐	躐.cn
躔	躔.cn
躞	躞.cn
身	身.cn
躬	躬.cn
躲	躲.cn
躺	躺.cn
辛	辛.cn
辜	辜.cn
辣	辣.cn
辨	辨.cn
辰	辰.cn
辱	辱.cn
迂	迂.cn
迄	迄.cn
迅	迅.cn
迆	迆.cn
迎	迎.cn
近	近.cn
迓	迓.cn
返	返.cn
迕	迕.cn
迢	迢.cn
迤	迤.cn
迥	迥.cn
迦	迦.cn
迨	迨.cn
迪	迪.cn
迫	迫.cn
迮	迮.cn
述	述.cn
迷	迷.cn
迸	迸.cn
追	追.cn
退	退.cn
送	送.cn
适	适.cn
逃	逃.cn
逄	逄.cn
逅	逅.cn
逆	逆.cn
逋	逋.cn
逍	逍.cn
透	透.cn
逐	逐.cn
逑	逑.cn
途	途.cn
逖	逖.cn
逗	逗.cn
通	通.cn
逛	逛.cn
逝	逝.cn
逞	逞.cn
速	速.cn
造	造.cn
逡	逡.cn
逢	逢.cn
逭	逭.cn
逮	逮.cn
逯	逯.cn
逵	逵.cn
逶	逶.cn
逸	逸.cn
遁	遁.cn
遂	遂.cn
遄	遄.cn
遇	遇.cn
遍	遍.cn
遏	遏.cn
遐	遐.cn
遑	遑.cn
遒	遒.cn
道	道.cn
遘	遘.cn
遛	遛.cn
遝	遝.cn
遢	遢.cn
遣	遣.cn
遨	遨.cn
遭	遭.cn
遮	遮.cn
遴	遴.cn
遵	遵.cn
遽	遽.cn
避	避.cn
邀	邀.cn
邂	邂.cn
邃	邃.cn
邈	邈.cn
邋	邋.cn
邙	邙.cn
邡	邡.cn
那	那.cn
邪	邪.cn
邰	邰.cn
邳	邳.cn
邴	邴.cn
邶	邶.cn
邸	邸.cn
郃	郃.cn
郅	郅.cn
郊	郊.cn
郎	郎.cn
郛	郛.cn
郜	郜.cn
郢	郢.cn
部	部.cn
郭	郭.cn
郯	郯.cn
郾	郾.cn
鄂	鄂.cn
鄄	鄄.cn
鄗	鄗.cn
鄘	鄘.cn
鄙	鄙.cn
鄢	鄢.cn
鄣	鄣.cn
鄹	鄹.cn
酃	酃.cn
酆	酆.cn
酇	酇.cn
酉	酉.cn
酋	酋.cn
酗	酗.cn
酚	酚.cn
酡	酡.cn
酲	酲.cn
酸	酸.cn
酹	酹.cn
醅	醅.cn
醇	醇.cn
醉	醉.cn
醋	醋.cn
醚	醚.cn
醛	醛.cn
醪	醪.cn
醮	醮.cn
醵	醵.cn
鈒	鈒.cn
鈲	鈲.cn
鉼	鉼.cn
銎	銎.cn
鋮	鋮.cn
錂	錂.cn
錏	錏.cn
鍪	鍪.cn
鎏	鎏.cn
鎯	鎯.cn
鏊	鏊.cn
鏍	鏍.cn
鏖	鏖.cn
鐎	鐎.cn
鐏	鐏.cn
閍	閍.cn
閐	閐.cn
闤	闤.cn
阜	阜.cn
阢	阢.cn
阪	阪.cn
防	防.cn
陀	陀.cn
陋	陋.cn
降	降.cn
限	限.cn
陔	陔.cn
陛	陛.cn
陝	陝.cn
陟	陟.cn
院	院.cn
陪	陪.cn
陬	陬.cn
陲	陲.cn
陵	陵.cn
陶	陶.cn
陷	陷.cn
隈	隈.cn
隍	隍.cn
隔	隔.cn
隗	隗.cn
隘	隘.cn
隙	隙.cn
障	障.cn
隧	隧.cn
隰	隰.cn
隹	隹.cn
隼	隼.cn
雀	雀.cn
雁	雁.cn
雄	雄.cn
雅	雅.cn
集	集.cn
雉	雉.cn
雊	雊.cn
雌	雌.cn
雍	雍.cn
雎	雎.cn
雒	雒.cn
雩	雩.cn
雪	雪.cn
雯	雯.cn
零	零.cn
雷	雷.cn
雹	雹.cn
需	需.cn
霄	霄.cn
霆	霆.cn
震	震.cn
霈	霈.cn
霉	霉.cn
霍	霍.cn
霎	霎.cn
霏	霏.cn
霖	霖.cn
霜	霜.cn
霞	霞.cn
霢	霢.cn
霤	霤.cn
霪	霪.cn
霰	霰.cn
露	露.cn
霸	霸.cn
霹	霹.cn
霾	霾.cn
靖	靖.cn
靛	靛.cn
非	非.cn
靠	靠.cn
靡	靡.cn
鞍	鞍.cn
鞔	鞔.cn
鞘	鞘.cn
鞝	鞝.cn
鞫	鞫.cn
音	音.cn
韶	韶.cn
韹	韹.cn
颻	颻.cn
颾	颾.cn
食	食.cn
#飢	飢.cn
飣	飣.cn
飧	飧.cn
餐	餐.cn
餕	餕.cn
餖	餖.cn
餮	餮.cn
饔	饔.cn
饕	饕.cn
馥	馥.cn
馨	馨.cn
駩	駩.cn
駰	駰.cn
騔	騔.cn
騚	騚.cn
騝	騝.cn
鬃	鬃.cn
騧	騧.cn
騪	騪.cn
驌	驌.cn
驦	驦.cn
骨	骨.cn
骰	骰.cn
骱	骱.cn
骷	骷.cn
骸	骸.cn
骼	骼.cn
髀	髀.cn
髁	髁.cn
髂	髂.cn
髑	髑.cn
髓	髓.cn
高	高.cn
髟	髟.cn
髡	髡.cn
髦	髦.cn
髫	髫.cn
髭	髭.cn
髯	髯.cn
髹	髹.cn
髻	髻.cn
鬁	鬁.cn
鬈	鬈.cn
鬎	鬎.cn
鬟	鬟.cn
鬣	鬣.cn
鬲	鬲.cn
鬻	鬻.cn
鬼	鬼.cn
魁	魁.cn
魂	魂.cn
魃	魃.cn
魄	魄.cn
魅	魅.cn
魈	魈.cn
魍	魍.cn
魏	魏.cn
魑	魑.cn
魔	魔.cn
鮞	鮞.cn
鯈	鯈.cn
鳼	鳼.cn
鵚	鵚.cn
鵷	鵷.cn
鶸	鶸.cn
鷁	鷁.cn
鷈	鷈.cn
鷨	鷨.cn
鷫	鷫.cn
鷿	鷿.cn
鸂	鸂.cn
鹿	鹿.cn
麂	麂.cn
麇	麇.cn
麈	麈.cn
麋	麋.cn
麒	麒.cn
麓	麓.cn
麝	麝.cn
麟	麟.cn
麾	麾.cn
黍	黍.cn
黎	黎.cn
黏	黏.cn
黔	黔.cn
黜	黜.cn
黝	黝.cn
黟	黟.cn
黠	黠.cn
黥	黥.cn
黯	黯.cn
黲	黲.cn
黹	黹.cn
黻	黻.cn
黼	黼.cn
鼎	鼎.cn
鼐	鼐.cn
鼙	鼙.cn
鼠	鼠.cn
鼢	鼢.cn
鼬	鼬.cn
鼯	鼯.cn
鼷	鼷.cn
齗	齗.cn
勘	勘.cn
堪	堪.cn
留	留.cn
