#人工校正（宁必須放在寧前方，否則會誤轉）
佇	伫
竚	伫
紵	纻
苧	苎

#第一表
#不作简化偏旁用的简化字
#本表共收简化字350个，按读音的拼音字母顺序排列。本表的简化字都不得作简化偏旁使用。
礙	碍
骯	肮
襖	袄
壩	坝
闆	板
辦	办
幫	帮
寳	宝
報	报
幣	币
斃	毙
標	标
錶	表
彆	别
蔔	卜
補	补
纔	才
蠶	蚕
燦	灿
層	层
攙	搀
讒	谗
饞	馋
纏	缠
懺	忏
償	偿
廠	厂
徹	彻
塵	尘
襯	衬
稱	称
懲	惩
遲	迟
衝	冲
醜	丑
齣	出
礎	础
處	处
觸	触
辭	辞
聰	聪
叢	丛
擔	担
膽	胆
導	导
燈	灯
鄧	邓
敵	敌
糴	籴
遞	递
點	点
澱	淀
電	电
鼕	冬
鬥	斗
獨	独
噸	吨
奪	夺
墮	堕
兒	儿
礬	矾
範	范
飛	飞
墳	坟
奮	奋
糞	粪
鳳	凤
膚	肤
婦	妇
復	复
複	复
蓋	盖
乾	干
幹	干
趕	赶
個	个
鞏	巩
溝	沟
構	构
購	购
穀	谷
顧	顾
颳	刮
關	关
觀	观
櫃	柜
漢	汉
號	号
閤	合
轟	轰
後	后
鬍	胡
壺	壶
滬	沪
護	护
劃	划
懷	怀
壞	坏
歡	欢
環	环
還	还
迴	回
夥	伙
獲	获
穫	获
擊	击
鷄	鸡
積	积
極	极
際	际
繼	继
傢	家
價	价
艱	艰
殲	歼
繭	茧
揀	拣
鹼	硷
艦	舰
薑	姜
漿	浆
槳	桨
奬	奖
講	讲
醬	酱
膠	胶
階	阶
癤	疖
潔	洁
藉	借
僅	仅
驚	惊
競	竞
舊	旧
劇	剧
據	据
懼	惧
捲	卷
開	开
剋	克
墾	垦
懇	恳
誇	夸
塊	块
虧	亏
睏	困
臘	腊
蠟	蜡
蘭	兰
攔	拦
欄	栏
爛	烂
纍	累
壘	垒
類	类
裏	里
禮	礼
隸	隶
簾	帘
聯	联
憐	怜
煉	炼
練	练
糧	粮
療	疗
遼	辽
瞭	了
獵	猎
臨	临
鄰	邻
嶺	岭
廬	庐
蘆	芦
爐	炉
陸	陆
驢	驴
亂	乱
麽	么
黴	霉
矇	蒙
濛	蒙
懞	蒙
夢	梦
麵	面
廟	庙
滅	灭
衊	蔑
畝	亩
惱	恼
腦	脑
擬	拟
釀	酿
瘧	疟
盤	盘
闢	辟
蘋	苹
憑	凭
撲	扑
僕	仆
樸	朴
啓	启
籤	签
韆	千
牽	牵
縴	纤
纖	纤
竅	窍
竊	窃
寢	寝
慶	庆
瓊	琼
鞦	秋
麯	曲
權	权
勸	劝
確	确
讓	让
擾	扰
熱	热
認	认
灑	洒
傘	伞
喪	丧
掃	扫
澀	涩
曬	晒
傷	伤
捨	舍
瀋	沈
聲	声
勝	胜
濕	湿
實	实
適	适
勢	势
獸	兽
書	书
術	术
樹	树
帥	帅
鬆	松
蘇	苏
囌	苏
雖	虽
隨	随
臺	台
檯	台
颱	台
態	态
壇	坛
罎	坛
嘆	叹
謄	誊
體	体
糶	粜
鐵	铁
聽	听
廳	厅
頭	头
圖	图
塗	涂
團	团
糰	团
橢	椭
窪	洼
襪	袜
網	网
衛	卫
穩	稳
務	务
霧	雾
犧	牺
習	习
係	系
繫	系
戲	戏
蝦	虾
嚇	吓
鹹	咸
顯	显
憲	宪
縣	县
響	响
嚮	向
協	协
脅	胁
褻	亵
釁	衅
興	兴
鬚	须
懸	悬
選	选
鏇	旋
壓	压
鹽	盐
陽	阳
養	养
癢	痒
樣	样
鑰	钥
藥	药
爺	爷
葉	叶
醫	医
億	亿
憶	忆
應	应
癰	痈
擁	拥
傭	佣
踴	踊
憂	忧
優	优
郵	邮
餘	余
禦	御
籲	吁
鬱	郁
譽	誉
淵	渊
園	园
遠	远
願	愿
躍	跃
運	运
醖	酝
雜	杂
贜	赃
臟	脏
髒	脏
鑿	凿
棗	枣
竈	灶
齋	斋
氈	毡
戰	战
趙	赵
摺	折
這	这
徵	征
癥	症
證	证
隻	只
衹	只
緻	致
製	制
鐘	钟
鍾	钟
腫	肿
種	种
衆	众
晝	昼
硃	朱
燭	烛
築	筑
莊	庄
樁	桩
妝	妆
裝	装
壯	壮
狀	状
準	准
濁	浊
總	总
鑽	钻
#第二表
#可作简化偏旁用的简化字和简化偏旁
#本表共收简化字132个和简化偏旁14个。简化字按读音的拼音字母顺序排列，简化偏旁按笔数排列。
愛	爱
罷	罢
備	备
貝	贝
筆	笔
畢	毕
邊	边
賓	宾
參	参
倉	仓
産	产
長	长
嘗	尝
車	车
齒	齿
蟲	虫
芻	刍
從	从
竄	窜
達	达
帶	带
單	单
當	当
噹	当
黨	党
東	东
動	动
斷	断
對	对
隊	队
爾	尔
發	发
髮	发
豐	丰
風	风
岡	冈
廣	广
歸	归
龜	龟
國	国
過	过
華	华
畫	画
匯	汇
彙	汇
會	会
幾	几
夾	夹
戔	戋
監	监
見	见
薦	荐
將	将
節	节
盡	尽
儘	尽
進	进
舉	举
殼	壳
來	来
樂	乐
離	离
歷	历
曆	历
麗	丽
兩	两
靈	灵
劉	刘
龍	龙
婁	娄
盧	卢
虜	虏
鹵	卤
滷	卤
録	录
慮	虑
侖	仑
羅	罗
馬	马
買	买
賣	卖
麥	麦
門	门
黽	黾
難	难
鳥	鸟
聶	聂
寧	宁
農	农
齊	齐
豈	岂
氣	气
遷	迁
僉	佥
喬	乔
親	亲
窮	穷
區	区
嗇	啬
殺	杀
審	审
聖	圣
師	师
時	时
壽	寿
屬	属
雙	双
肅	肃
歲	岁
孫	孙
條	条
萬	万
爲	为
韋	韦
烏	乌
無	无
獻	献
鄉	乡
寫	写
尋	寻
亞	亚
嚴	严
厭	厌
堯	尧
業	业
頁	页
義	义
藝	艺
陰	阴
隱	隐
猶	犹
魚	鱼
與	与
雲	云
鄭	郑
執	执
質	质
專	专
#第三表
#本表共收简化字1,753个（不包含重见的字。例如“缆”分见“纟、𰀢、见”三部，只算一字），以第二表中的简化字和简化偏旁作部首，按第二表的顺序排列。同一部首中的简化字，按笔数排列。
噯	嗳
嬡	嫒
靉	叆
璦	瑷
曖	暧
擺	摆
襬	摆
羆	罴
䎱	䎬
憊	惫
貞	贞
則	则
負	负
貢	贡
唄	呗
員	员
財	财
狽	狈
責	责
厠	厕
賢	贤
賬	账
販	贩
貶	贬
敗	败
貯	贮
貪	贪
貧	贫
偵	侦
側	侧
貨	货
貫	贯
測	测
湞	浈
惻	恻
貳	贰
賁	贲
貰	贳
費	费
鄖	郧
勛	勋
幀	帧
貼	贴
貺	贶
貽	贻
賤	贱
貴	贵
鋇	钡
貸	贷
貿	贸
賀	贺
隕	陨
溳	涢
資	资
禎	祯
賈	贾
損	损
贄	贽
塤	埙
楨	桢
嗊	唝
嗩	唢
賅	赅
圓	圆
賊	贼
賄	贿
贐	赆
賂	赂
債	债
賃	赁
漬	渍
慣	惯
瑣	琐
賚	赉
匱	匮
摜	掼
殞	殒
勩	勚
賑	赈
嬰	婴
嘖	啧
賒	赊
幘	帻
僨	偾
鍘	铡
績	绩
潰	溃
濺	溅
賡	赓
憒	愦
憤	愤
蕢	蒉
賫	赍
蕆	蒇
䝼	䞍
賠	赔
賧	赕
遺	遗
賦	赋
噴	喷
賭	赌
贖	赎
賞	赏
賜	赐
賙	赒
鎖	锁
饋	馈
賴	赖
赬	赪
磧	碛
殨	㱮
賵	赗
膩	腻
賽	赛
䙡	䙌
贅	赘
攖	撄
檟	槚
嚶	嘤
賺	赚
賻	赙
罌	罂
鐨	镄
簀	箦
鰂	鲗
纓	缨
瓔	璎
聵	聩
櫻	樱
賾	赜
簣	篑
瀨	濑
癭	瘿
懶	懒
贋	赝
豶	豮
贈	赠
鸚	鹦
獺	獭
贊	赞
贏	赢
贍	赡
癩	癞
攢	攒
籟	籁
纘	缵
瓚	瓒
臢	臜
贛	赣
趲	趱
躦	躜
戇	戆
潷	滗
蓽	荜
嗶	哔
篳	筚
蹕	跸
籩	笾
儐	傧
濱	滨
擯	摈
嬪	嫔
繽	缤
殯	殡
檳	槟
臏	膑
鑌	镔
髕	髌
鬢	鬓
滲	渗
慘	惨
摻	掺
驂	骖
毿	毵
瘮	瘆
磣	碜
穇	䅟
糝	糁
傖	伧
創	创
滄	沧
愴	怆
蒼	苍
搶	抢
嗆	呛
熗	炝
瑲	玱
槍	枪
戧	戗
瘡	疮
鶬	鸧
艙	舱
蹌	跄
滻	浐
薩	萨
鏟	铲
倀	伥
悵	怅
帳	帐
張	张
棖	枨
賬	账
脹	胀
漲	涨
鱨	鲿
軋	轧
軍	军
軌	轨
厙	厍
陣	阵
庫	库
連	连
軒	轩
諢	诨
鄆	郓
軔	轫
軛	轭
匭	匦
轉	转
輪	轮
斬	斩
軟	软
渾	浑
惲	恽
硨	砗
軼	轶
軻	轲
軲	轱
軤	轷
輕	轻
轤	轳
軸	轴
揮	挥
葷	荤
轢	轹
軫	轸
軺	轺
漣	涟
琿	珲
載	载
蓮	莲
較	较
軾	轼
輊	轾
輅	辂
轎	轿
暈	晕
漸	渐
慚	惭
皸	皲
璉	琏
輔	辅
輒	辄
輛	辆
塹	堑
囀	啭
嶄	崭
褲	裤
褳	裢
輦	辇
輞	辋
輟	辍
輥	辊
槧	椠
輜	辎
暫	暂
輝	辉
輩	辈
鏈	链
翬	翚
輳	辏
輻	辐
輯	辑
輸	输
轂	毂
轡	辔
轄	辖
轅	辕
輾	辗
輿	舆
轆	辘
攆	撵
鰱	鲢
轍	辙
鏨	錾
轔	辚
齔	龀
嚙	啮
齠	龆
齙	龅
齟	龃
齡	龄
齜	龇
齦	龈
齬	龉
齪	龊
齷	龌
齲	龋
蠱	蛊
謅	诌
㑳	㑇
鄒	邹
㥮	㤘
騶	驺
縐	绉
皺	皱
趨	趋
雛	雏
蓯	苁
縱	纵
樅	枞
慫	怂
聳	耸
攛	撺
鑹	镩
躥	蹿
澾	㳠
闥	闼
撻	挞
噠	哒
韃	鞑
滯	滞
鄲	郸
憚	惮
闡	阐
撣	掸
彈	弹
嬋	婵
禪	禅
殫	殚
癉	瘅
蟬	蝉
簞	箪
蘄	蕲
囅	冁
擋	挡
檔	档
襠	裆
鐺	铛
讜	谠
儻	傥
钂	镋
凍	冻
陳	陈
崬	岽
棟	栋
腖	胨
鶇	鸫
慟	恸
籪	簖
懟	怼
墜	坠
邇	迩
彌	弥
瀰	弥
禰	祢
璽	玺
獼	猕
潑	泼
廢	废
撥	拨
鏺	䥽
灃	沣
艷	艳
灧	滟
諷	讽
渢	沨
嵐	岚
楓	枫
瘋	疯
颯	飒
碸	砜
颶	飓
颸	飔
颼	飕
飀	飗
飄	飘
飆	飙
剛	刚
掆	㧏
崗	岗
綱	纲
棡	㭎
鋼	钢
鄺	邝
壙	圹
擴	扩
獷	犷
纊	纩
曠	旷
礦	矿
巋	岿
鬮	阄
摑	掴
幗	帼
膕	腘
蟈	蝈
撾	挝
嘩	哗
驊	骅
燁	烨
樺	桦
曄	晔
鏵	铧
嫿	婳
擓	㧟
劊	刽
鄶	郐
儈	侩
澮	浍
薈	荟
噲	哙
獪	狯
繪	绘
燴	烩
檜	桧
膾	脍
鱠	鲙
譏	讥
嘰	叽
饑	饥
機	机
璣	玑
磯	矶
蟣	虮
郟	郏
俠	侠
陝	陕
浹	浃
挾	挟
莢	荚
峽	峡
狹	狭
愜	惬
硤	硖
鋏	铗
頰	颊
蛺	蛱
瘞	瘗
篋	箧
剗	刬
淺	浅
餞	饯
綫	线
殘	残
棧	栈
賤	贱
盞	盏
錢	钱
箋	笺
濺	溅
踐	践
濫	滥
藍	蓝
尷	尴
檻	槛
襤	褴
籃	篮
莧	苋
峴	岘
覎	觃
視	视
規	规
現	现
梘	枧
覓	觅
覺	觉
硯	砚
覘	觇
覽	览
寬	宽
蜆	蚬
覬	觊
筧	笕
覡	觋
覿	觌
靚	靓
攪	搅
攬	揽
纜	缆
窺	窥
欖	榄
覦	觎
覯	觏
覲	觐
覷	觑
髖	髋
韉	鞯
蔣	蒋
鏘	锵
櫛	栉
濜	浕
藎	荩
燼	烬
贐	赆
璡	琎
櫸	榉
慤	悫
淶	涞
萊	莱
崍	崃
徠	徕
賚	赉
睞	睐
錸	铼
濼	泺
爍	烁
櫟	栎
轢	轹
礫	砾
鑠	铄
灕	漓
籬	篱
瀝	沥
壢	坜
藶	苈
嚦	呖
櫪	枥
癧	疬
靂	雳
儷	俪
酈	郦
邐	逦
驪	骊
鸝	鹂
釃	酾
鱺	鲡
倆	俩
啢	唡
輛	辆
滿	满
瞞	瞒
顢	颟
蟎	螨
魎	魉
懣	懑
蹣	蹒
欞	棂
瀏	浏
隴	陇
瀧	泷
寵	宠
龐	庞
壟	垄
攏	拢
蘢	茏
嚨	咙
瓏	珑
櫳	栊
龑	䶮
曨	昽
朧	胧
礱	砻
襲	袭
聾	聋
龔	龚
龕	龛
籠	笼
讋	詟
僂	偻
漊	溇
蔞	蒌
摟	搂
嶁	嵝
嘍	喽
縷	缕
屢	屡
數	数
樓	楼
瘻	瘘
褸	褛
窶	窭
瞜	䁖
鏤	镂
屨	屦
螻	蝼
簍	篓
耬	耧
藪	薮
擻	擞
髏	髅
瀘	泸
壚	垆
櫨	栌
轤	轳
臚	胪
鸕	鸬
顱	颅
艫	舻
鱸	鲈
擄	掳
鹺	鹾
籙	箓
濾	滤
攄	摅
論	论
倫	伦
淪	沦
掄	抡
圇	囵
綸	纶
輪	轮
癟	瘪
蘿	萝
囉	啰
邏	逻
玀	猡
欏	椤
鑼	锣
籮	箩
馮	冯
馭	驭
闖	闯
嗎	吗
獁	犸
馱	驮
馳	驰
馴	驯
媽	妈
瑪	玛
驅	驱
駁	驳
碼	码
駝	驼
駐	驻
駔	驵
駕	驾
驛	驿
駟	驷
駛	驶
駒	驹
騶	驺
駘	骀
駙	驸
駑	驽
駡	骂
螞	蚂
篤	笃
駭	骇
駢	骈
驍	骁
驕	骄
驊	骅
駱	骆
驪	骊
騁	骋
驗	验
駿	骏
駸	骎
騎	骑
騏	骐
騍	骒
騅	骓
驂	骖
騙	骗
騭	骘
騖	骛
騷	骚
騫	骞
驁	骜
驀	蓦
騰	腾
騮	骝
騸	骟
驃	骠
驄	骢
騾	骡
羈	羁
驟	骤
驥	骥
驤	骧
蕒	荬
讀	读
瀆	渎
續	续
櫝	椟
覿	觌
贖	赎
犢	犊
牘	牍
竇	窦
黷	黩
嘜	唛
麩	麸
閂	闩
閃	闪
們	们
閉	闭
闖	闯
問	问
捫	扪
闈	闱
閔	闵
悶	闷
閏	闰
閑	闲
間	间
鬧	闹
閘	闸
鍆	钔
閡	阂
閨	闺
聞	闻
闥	闼
閩	闽
閭	闾
闓	闿
䦛	䦶
閣	阁
閥	阀
潤	润
澗	涧
憫	悯
閬	阆
閲	阅
閫	阃
鬮	阄
䦟	䦷
嫻	娴
閼	阏
閾	阈
閹	阉
閶	阊
閽	阍
閿	阌
鬩	阋
闡	阐
閻	阎
燜	焖
闌	阑
襇	裥
闊	阔
癇	痫
鷴	鹇
鷳	鹇
鷳	鹇
闋	阕
闃	阒
擱	搁
鐧	锏
鐦	锎
闕	阙
闔	阖
闐	阗
櫚	榈
簡	简
讕	谰
闞	阚
藺	蔺
瀾	澜
斕	斓
㘚	㘎
鑭	镧
躪	躏
澠	渑
繩	绳
黿	鼋
蠅	蝇
鼉	鼍
儺	傩
灘	滩
攤	摊
癱	瘫
鳬	凫
鳩	鸠
島	岛
蔦	茑
鳶	鸢
鳴	鸣
梟	枭
鴆	鸩
鴉	鸦
鳾	䴓
鷗	鸥
鴇	鸨
鶬	鸧
窵	窎
鶯	莺
鴣	鸪
搗	捣
鶇	鸫
鸕	鸬
鴨	鸭
鴦	鸯
鴞	鸮
鴝	鸲
鴒	鸰
鴛	鸳
鴕	鸵
裊	袅
鴟	鸱
鷥	鸶
鸞	鸾
鵁	䴔
鴻	鸿
鷙	鸷
鴯	鸸
鴷	䴕
鵃	鸼
鴿	鸽
鴰	鸹
鵂	鸺
鴴	鸻
鵜	鹈
鷴	鹇
鷳	鹇
鵓	鹁
鸝	鹂
鵑	鹃
鵒	鹆
鵠	鹄
鵝	鹅
鶉	鹑
鶊	鹒
鶄	䴖
鵡	鹉
鵲	鹊
鶓	鹋
鵪	鹌
鵬	鹏
鵮	鹐
鷀	鹚
鶘	鹕
鶡	鹖
鶪	䴗
鶚	鹗
鶻	鹘
鶖	鹙
鶩	鹜
鶥	鹛
鶴	鹤
鶼	鹣
鷂	鹞
鶺	鹡
鷉	䴘
鷓	鹧
鷖	鹥
鸚	鹦
鷚	鹨
鷲	鹫
鷯	鹩
鷦	鹪
鷸	鹬
鷹	鹰
鸇	鹯
鷺	鹭
鸊	䴙
鸛	鹳
懾	慑
灄	滠
攝	摄
囁	嗫
鑷	镊
顳	颞
躡	蹑
濘	泞
擰	拧
嚀	咛
獰	狞
檸	柠
聹	聍
儂	侬
濃	浓
噥	哝
膿	脓
劑	剂
儕	侪
濟	济
薺	荠
擠	挤
臍	脐
蠐	蛴
躋	跻
霽	霁
鱭	鲚
齏	齑
剴	剀
凱	凯
愷	恺
闓	闿
塏	垲
榿	桤
覬	觊
磑	硙
皚	皑
鎧	铠
愾	忾
餼	饩
躚	跹
劍	剑
儉	俭
險	险
撿	捡
獫	猃
驗	验
檢	检
殮	殓
斂	敛
臉	脸
襝	裣
瞼	睑
簽	签
瀲	潋
蘞	蔹
僑	侨
撟	挢
蕎	荞
嶠	峤
驕	骄
嬌	娇
橋	桥
轎	轿
礄	硚
矯	矫
鞽	鞒
櫬	榇
藭	䓖
謳	讴
傴	伛
漚	沤
慪	怄
摳	抠
奩	奁
嘔	呕
嶇	岖
嫗	妪
驅	驱
樞	枢
甌	瓯
歐	欧
毆	殴
鷗	鸥
瞘	眍
軀	躯
薔	蔷
墻	墙
嬙	嫱
檣	樯
穡	穑
鎩	铩
讅	谉
嬸	婶
檉	柽
蟶	蛏
溮	浉
獅	狮
螄	蛳
篩	筛
塒	埘
蒔	莳
鰣	鲥
儔	俦
濤	涛
禱	祷
燾	焘
疇	畴
鑄	铸
籌	筹
躊	踌
囑	嘱
矚	瞩
㩳	㧐
蕭	萧
嘯	啸
瀟	潇
簫	箫
蠨	蟏
劌	刿
噦	哕
穢	秽
蓀	荪
猻	狲
遜	逊
滌	涤
縧	绦
鰷	鲦
厲	厉
邁	迈
勵	励
癘	疠
蠆	虿
躉	趸
礪	砺
糲	粝
蠣	蛎
僞	伪
潙	沩
嬀	妫
諱	讳
偉	伟
闈	闱
違	违
葦	苇
韌	韧
幃	帏
圍	围
緯	纬
煒	炜
禕	祎
瑋	玮
韍	韨
潿	涠
韓	韩
韞	韫
韙	韪
韜	韬
鄔	邬
塢	坞
嗚	呜
鎢	钨
憮	怃
廡	庑
撫	抚
蕪	芜
嘸	呒
嫵	妩
讞	谳
薌	芗
饗	飨
瀉	泻
潯	浔
蕁	荨
撏	挦
鱘	鲟
堊	垩
埡	垭
掗	挜
啞	哑
婭	娅
惡	恶
噁	恶
氬	氩
壼	壸
儼	俨
釅	酽
懨	恹
厴	厣
靨	靥
饜	餍
魘	魇
黶	黡
僥	侥
澆	浇
撓	挠
蕘	荛
嶢	峣
嘵	哓
嬈	娆
驍	骁
繞	绕
饒	饶
燒	烧
橈	桡
曉	晓
磽	硗
鐃	铙
翹	翘
蟯	蛲
蹺	跷
鄴	邺
頂	顶
頃	顷
項	项
頇	顸
順	顺
須	须
頏	颃
煩	烦
頊	顼
頑	顽
頓	顿
頎	颀
頒	颁
頌	颂
傾	倾
預	预
廎	庼
碩	硕
顱	颅
領	领
頸	颈
頗	颇
頦	颏
頰	颊
頡	颉
潁	颍
頜	颌
頲	颋
澦	滪
頤	颐
蕷	蓣
頻	频
頽	颓
頷	颔
穎	颖
顆	颗
額	额
顔	颜
擷	撷
題	题
顒	颙
顓	颛
纈	缬
瀕	濒
顛	颠
顢	颟
顳	颞
顙	颡
囂	嚣
顥	颢
顫	颤
巔	巅
顬	颥
癲	癫
灝	灏
顰	颦
顴	颧
議	议
儀	仪
蟻	蚁
囈	呓
蔭	荫
癮	瘾
蕕	莸
魛	鱽
漁	渔
魴	鲂
魷	鱿
魯	鲁
鱟	鲎
薊	蓟
鮃	鲆
鮍	鲏
鮁	鲅
鱸	鲈
鮎	鲇
鮓	鲊
鮣	䲟
穌	稣
鮒	鲋
鮑	鲍
鮐	鲐
鯗	鲞
鮺	鲝
鱭	鲚
鮫	鲛
鮮	鲜
鮭	鲑
鮚	鲒
鮪	鲔
鱘	鲟
鰂	鲗
鮦	鲖
鱠	鲙
鯊	鲨
嚕	噜
鱺	鲡
鯁	鲠
鰱	鲢
鯽	鲫
鰣	鲥
鯇	鲩
鰹	鲣
鯉	鲤
鰷	鲦
鯀	鲧
櫓	橹
氌	氇
鯨	鲸
鯖	鲭
鯪	鲮
鯫	鲰
鯤	鲲
鯔	鲻
鯧	鲳
鯡	鲱
鯢	鲵
鯛	鲷
鯰	鲶
蘚	藓
鰌	䲡
鰆	䲠
鱨	鲿
鯿	鳊
鰈	鲽
鰛	鳁
鰓	鳃
鰐	鳄
鑥	镥
鰍	鳅
鰒	鳆
鰉	鳇
鰲	鳌
䱷	䲣
鰧	䲢
鰜	鳒
鰭	鳍
鰨	鳎
鰥	鳏
鰟	鳑
癬	癣
鱉	鳖
鱅	鳙
鰼	鳛
鱈	鳕
鰾	鳔
鰳	鳓
鰵	鳘
鰻	鳗
鱔	鳝
鱒	鳟
鱗	鳞
鱖	鳜
鱣	鳣
鱧	鳢
嶼	屿
歟	欤
蕓	芸
曇	昙
靉	叆
靆	叇
擲	掷
躑	踯
墊	垫
摯	挚
贄	贽
鷙	鸷
蟄	蛰
縶	絷
鑕	锧
躓	踬
傳	传
摶	抟
轉	转
膞	䏝
磚	砖
囀	啭
計	计
訂	订
訃	讣
譏	讥
議	议
討	讨
訌	讧
訐	讦
記	记
訊	讯
訕	讪
訓	训
訖	讫
訪	访
訝	讶
諱	讳
詎	讵
謳	讴
訣	诀
訥	讷
設	设
諷	讽
訛	讹
訢	䜣
許	许
論	论
訟	讼
訩	讻
詁	诂
訶	诃
評	评
詔	诏
詞	词
譯	译
詘	诎
詗	诇
詛	诅
識	识
謅	诌
詆	诋
訴	诉
詐	诈
診	诊
詒	诒
諢	诨
該	该
詳	详
詫	诧
誆	诓
詿	诖
詰	诘
詼	诙
試	试
詩	诗
詡	诩
諍	诤
詮	诠
誅	诛
誄	诔
詬	诟
詣	诣
話	话
詭	诡
詢	询
誠	诚
誕	诞
滸	浒
誚	诮
説	说
誡	诫
誣	诬
語	语
誦	诵
罰	罚
誤	误
誥	诰
誑	诳
誘	诱
誨	诲
誒	诶
獄	狱
誼	谊
諒	谅
談	谈
諄	谆
讅	谉
誶	谇
請	请
諾	诺
諸	诸
讀	读
諑	诼
諏	诹
課	课
誹	诽
諉	诿
誰	谁
諛	谀
調	调
諂	谄
諗	谂
諦	谛
諳	谙
謎	谜
諺	谚
諞	谝
諮	谘
諶	谌
謊	谎
謀	谋
諜	谍
諧	谐
諫	谏
諝	谞
謔	谑
謁	谒
諤	谔
謂	谓
諼	谖
諭	谕
謚	谥
謗	谤
謙	谦
謐	谧
謨	谟
讜	谠
謖	谡
謝	谢
謠	谣
儲	储
謫	谪
謭	谫
謹	谨
謬	谬
謾	谩
譜	谱
譖	谮
譚	谭
讕	谰
譎	谲
譙	谯
藹	蔼
櫧	槠
譴	谴
譫	谵
讞	谳
辯	辩
讌	䜩
讎	雠
讖	谶
靄	霭
饑	饥
飥	饦
餳	饧
飩	饨
飯	饭
飲	饮
飫	饫
餼	饩
飪	饪
飭	饬
飼	饲
餞	饯
飾	饰
飽	饱
飴	饴
飿	饳
餄	饸
餉	饷
餃	饺
餏	饻
餅	饼
餌	饵
饒	饶
蝕	蚀
餎	饹
餑	饽
餒	馁
餓	饿
館	馆
餛	馄
餜	馃
餡	馅
餶	馉
餷	馇
饋	馈
餿	馊
饈	馐
饃	馍
餺	馎
餾	馏
饉	馑
饅	馒
饊	馓
饌	馔
饢	馕
湯	汤
揚	扬
場	场
暘	旸
餳	饧
煬	炀
楊	杨
腸	肠
瘍	疡
碭	砀
暢	畅
鍚	钖
殤	殇
蕩	荡
燙	烫
觴	觞
絲	丝
糾	纠
纊	纩
紆	纡
紂	纣
紅	红
紀	纪
紉	纫
紇	纥
約	约
紈	纨
級	级
紡	纺
紋	纹
緯	纬
紜	纭
純	纯
紕	纰
紐	纽
納	纳
綱	纲
紗	纱
紝	纴
紛	纷
綸	纶
紙	纸
縱	纵
紓	纾
紖	纼
噝	咝
絆	绊
綫	线
紺	绀
紲	绁
紱	绂
紼	绋
繹	绎
經	经
紹	绍
組	组
細	细
紬	䌷
紳	绅
織	织
絀	绌
終	终
縐	绉
紿	绐
喲	哟
絰	绖
葤	荮
葒	荭
絞	绞
統	统
絨	绒
繞	绕
絝	绔
結	结
絎	绗
給	给
繪	绘
絶	绝
絳	绛
絡	络
絢	绚
綁	绑
蒓	莼
綆	绠
綈	绨
綃	绡
絹	绢
綉	绣
綏	绥
縧	绦
鷥	鸶
綜	综
綻	绽
綰	绾
綣	绻
績	绩
綾	绫
緒	绪
續	续
綺	绮
綴	缀
緑	绿
綽	绰
緄	绲
繩	绳
緋	绯
綬	绶
綢	绸
綳	绷
綹	绺
維	维
綿	绵
緇	缁
締	缔
編	编
縷	缕
緗	缃
緙	缂
緬	缅
緣	缘
緝	缉
緹	缇
緲	缈
緡	缗
緼	缊
緦	缌
纜	缆
緩	缓
緘	缄
緱	缑
縋	缒
緞	缎
轡	辔
縗	缞
繽	缤
縞	缟
縑	缣
縊	缢
縛	缚
縉	缙
縟	缛
縝	缜
縫	缝
縭	缡
濰	潍
縮	缩
縹	缥
繆	缪
縵	缦
纓	缨
繅	缫
縲	缧
藴	蕴
繕	缮
繒	缯
纈	缬
繚	缭
櫞	橼
繮	缰
繯	缳
繰	缲
繾	缱
繳	缴
辮	辫
纘	缵
堅	坚
賢	贤
腎	肾
竪	竖
慳	悭
緊	紧
鏗	铿
鰹	鲣
勞	劳
煢	茕
塋	茔
熒	荧
榮	荣
滎	荥
犖	荦
澇	涝
嶗	崂
瑩	莹
撈	捞
嘮	唠
鶯	莺
螢	萤
營	营
縈	萦
癆	痨
嶸	嵘
鐒	铹
耮	耢
蠑	蝾
覽	览
攬	揽
纜	缆
欖	榄
鑒	鉴
識	识
幟	帜
織	织
熾	炽
職	职
釓	钆
釔	钇
釕	钌
釙	钋
釘	钉
針	针
釗	钊
釵	钗
釺	钎
釣	钓
釧	钏
釷	钍
釤	钐
釩	钒
鍚	钖
釹	钕
鍆	钔
鈥	钬
鈁	钫
鈈	钚
釾	䥺
鈧	钪
鈀	钯
鈄	钭
鈣	钙
鈍	钝
鈦	钛
鈃	钘
鈕	钮
鈔	钞
鋼	钢
鈉	钠
鋇	钡
鈐	钤
鈞	钧
鈎	钩
欽	钦
鎢	钨
鉍	铋
鈺	钰
錢	钱
鉦	钲
鉗	钳
鈷	钴
鉞	钺
鉢	钵
鈸	钹
鉬	钼
鉀	钾
鈾	铀
鈿	钿
鐸	铎
鏺	䥽
鈴	铃
鉛	铅
鉑	铂
鑠	铄
鉚	铆
鈹	铍
鈳	钶
鉈	铊
鉭	钽
鈮	铌
鉕	钷
鈰	铈
鉉	铉
鉺	铒
銠	铑
銪	铕
銦	铟
銣	铷
銫	铯
銩	铥
鉿	铪
銱	铞
銚	铫
銨	铵
銜	衔
鏟	铲
鉸	铰
銃	铳
銥	铱
鋩	铓
鋏	铗
銬	铐
鉶	铏
鐃	铙
銀	银
鐺	铛
銅	铜
鋁	铝
鍘	铡
鎧	铠
銓	铨
銖	铢
銑	铣
鋌	铤
銘	铭
鉻	铬
錚	铮
鏵	铧
鎩	铩
撳	揿
鋅	锌
鋭	锐
銻	锑
鋃	锒
鋪	铺
鑄	铸
嶔	嵚
鋟	锓
鋥	锃
鏈	链
鏗	铿
鐧	锏
銷	销
鎖	锁
鋤	锄
鍋	锅
銼	锉
銹	锈
鋒	锋
鋯	锆
鐒	铹
鋦	锔
錒	锕
鐦	锎
鋱	铽
錸	铼
鋨	锇
鋰	锂
鑕	锧
鍩	锘
錁	锞
錠	锭
鍺	锗
鍀	锝
錇	锫
錯	错
錨	锚
錛	锛
鋸	锯
錳	锰
錮	锢
錕	锟
錫	锡
鑼	锣
錘	锤
錐	锥
錦	锦
鍁	锨
錙	锱
鍵	键
鍍	镀
鎡	镃
鎂	镁
鏤	镂
鍥	锲
鏘	锵
鍔	锷
鍶	锶
鍇	锴
鍰	锾
鍬	锹
鎄	锿
鎇	镅
鐨	镄
鍛	锻
鍤	锸
鎪	锼
鎿	镎
鎵	镓
钂	镋
鑌	镔
鎰	镒
䥇	䦂
鎊	镑
鎬	镐
鎘	镉
鑷	镊
鎮	镇
鎳	镍
鎸	镌
鎦	镏
鏡	镜
鏑	镝
鏞	镛
鏃	镞
鏢	镖
鏰	镚
鏜	镗
鐯	䦃
鏝	镘
鑹	镩
鐓	镦
鐥	䦅
鐠	镨
鑭	镧
鑥	镥
鏷	镤
鐝	镢
鐐	镣
鐙	镫
鏹	镪
鐮	镰
鐿	镱
鐳	镭
鑊	镬
鐶	镮
鐲	镯
鑔	镲
鑣	镳
鑞	镴
鑲	镶
钁	䦆
#鍾	锺
嶨	峃
學	学
覺	觉
攪	搅
嚳	喾
鱟	鲎
黌	黉
譯	译
澤	泽
懌	怿
擇	择
嶧	峄
繹	绎
驛	驿
鐸	铎
蘀	萚
釋	释
籜	箨
勁	劲
剄	刭
陘	陉
涇	泾
莖	茎
徑	径
經	经
烴	烃
輕	轻
氫	氢
脛	胫
痙	痉
羥	羟
頸	颈
巰	巯
變	变
彎	弯
孿	孪
巒	峦
孌	娈
戀	恋
欒	栾
攣	挛
鸞	鸾
灣	湾
蠻	蛮
臠	脔
灤	滦
鑾	銮
剮	剐
渦	涡
堝	埚
喎	㖞
萵	莴
媧	娲
禍	祸
腡	脶
窩	窝
鍋	锅
蝸	蜗
#附录
#以下39个字是从《第一批异体字整理表》摘录出来的。这些字习惯被看作简化字，附此以便检查。括弧里的字是停止使用的异体字。
獃	呆
騃	呆
跡	迹
蹟	迹
蔴	麻
蓆	席
韻	韵
佈	布
稭	秸
脈	脉
兇	凶
災	灾
癡	痴
傑	杰
貓	猫
繡	绣
剳	札
劄	札
牀	床
#鉅	巨
棲	栖
鏽	锈
紥	扎
紮	扎
脣	唇
崑	昆
崐	昆
棄	弃
巖	岩
佔	占
僱	雇
綑	捆
陞	升
昇	升
異	异
週	周
掛	挂
淚	泪
筍	笋
湧	涌
註	注
閧	哄
鬨	哄
釐	厘
牠	它
嶽	岳

#保留下來的二簡字
燉	炖

#人工校正 (補充漢字簡化方案裡已經適用，未廢止卻不知道為何沒收在簡化字總表裡的字)
牆	墙
錄	录

#人工校正 (從未定義繁簡或異體關係，但直接出現在現代漢語通用字表裡的簡化字)
屜	屉
嶴	岙
愨	悫

#人工校正 (屬類推簡化，未明列於第三表內，後直接出現在通現代漢語通用字表裡的簡化字)
憖	慭
瀠	潆
瀦	潴
灩	滟
璵	玙
瘲	疭
矓	眬
禡	祃
穠	秾
綌	绤
綯	绹
翽	翙
艤	舣
萇	苌
薘	荙
薴	苧
蘺	蓠
褌	裈
褘	袆
襉	裥
襏	袯
襴	襕
觶	觯
証	证
詖	诐
詵	诜
贇	赟
躂	跶
躒	跞
輇	辁
輈	辀
輬	辌
醯	酰
醱	酦
鈑	钣
銍	铚
鋝	锊
錆	锖
錈	锩
鏐	镠
鑱	镵
閌	闶
閎	闳
闍	阇
闒	阘
顎	颚
飢	饥
饁	馌
騂	骍
魨	鲀
鰩	鳐
鶲	鹟
鶹	鹠
齕	龁
咼	呙
嚲	亸
澐	沄
鷊	鹝
鸏	鹲
鳲	鸤
鳧	凫
鵯	鹎
鮶	鲪
鯕	鲯
鯷	鳀
勱	劢
嘽	啴
墶	垯
媯	妫
幬	帱
擼	撸
棶	梾
溈	沩
瀅	滢
獮	狝
瑒	玚
璫	珰
硜	硁
篔	筼
簹	筜
薟	莶
賕	赇
贔	赑
軑	轪
軹	轵
轀	辒
鋙	铻
錟	锬
錡	锜
鍠	锽
鎛	镈
鎣	蓥
鎲	镋
鏌	镆
鐋	铴
鐔	镡
颭	飐
颮	飑
騤	骙
驏	骣
屓	屃

