鎔	镕	#1993年
嶮	崄
撝	㧑
槤	梿
紘	纮
絅	䌹
縕	缊
訒	讱
誾	訚
貙	䝙
逕	迳
頫	𫖯
鑪	𬬻
勣	𪟝
鉅	钜
麴	麹
貲	赀
椏	桠
颺	飏
酇	酂
鋮	铖
鐏	𨱔
驌	骕
驦	骦
鮞	鲕
鷁	鹢
鷉	䴘
鷈	䴘
鷫	鹔
鷿	䴙
鹼	碱	#硷字廢除
黲	黪
齗	龂
駰	骃
鮸	𩾃
俔	伣
堖	垴
榪	杩
檮	梼
熲	颎
緔	绱
螮	䗖
銶	𨱇
鎝	𨱏
閆	闫
馹	驲
驫	骉